CDU_ID,GEO_CODE,GEO_LABEL,GEO_TYPE,GEO_TYP2,Age : Age 16 and over - General health : Total\ General health - Language; ability to speak Welsh [W] : Total\ Ability to speak Welsh - Unit : Persons,Age : Age 16 and over - General health : Total\ General health - Language; ability to speak Welsh [W] : Can speak Welsh - Unit : Persons,Age : Age 16 and over - General health : Total\ General health - Language; ability to speak Welsh [W] : Cannot speak Welsh - Unit : Persons
282776,W00000001,W00000001,Output Areas and Small Areas,OASA,309,194,115
282777,W00000002,W00000002,Output Areas and Small Areas,OASA,227,156,71
282778,W00000003,W00000003,Output Areas and Small Areas,OASA,297,179,118
282779,W00000004,W00000004,Output Areas and Small Areas,OASA,339,150,189
282780,W00000005,W00000005,Output Areas and Small Areas,OASA,389,237,152
282781,W00000006,W00000006,Output Areas and Small Areas,OASA,282,184,98
282782,W00000008,W00000008,Output Areas and Small Areas,OASA,254,156,98
282783,W00000009,W00000009,Output Areas and Small Areas,OASA,319,210,109
282784,W00000010,W00000010,Output Areas and Small Areas,OASA,247,97,150
282785,W00000011,W00000011,Output Areas and Small Areas,OASA,238,115,123
282786,W00000012,W00000012,Output Areas and Small Areas,OASA,250,118,132
282787,W00000013,W00000013,Output Areas and Small Areas,OASA,338,199,139
282788,W00000014,W00000014,Output Areas and Small Areas,OASA,211,93,118
282789,W00000015,W00000015,Output Areas and Small Areas,OASA,241,73,168
282790,W00000016,W00000016,Output Areas and Small Areas,OASA,200,74,126
282791,W00000017,W00000017,Output Areas and Small Areas,OASA,224,85,139
282792,W00000018,W00000018,Output Areas and Small Areas,OASA,206,79,127
282793,W00000019,W00000019,Output Areas and Small Areas,OASA,191,60,131
282794,W00000020,W00000020,Output Areas and Small Areas,OASA,184,76,108
282795,W00000021,W00000021,Output Areas and Small Areas,OASA,209,59,150
282796,W00000022,W00000022,Output Areas and Small Areas,OASA,259,198,61
282797,W00000023,W00000023,Output Areas and Small Areas,OASA,261,184,77
282798,W00000024,W00000024,Output Areas and Small Areas,OASA,301,188,113
282799,W00000025,W00000025,Output Areas and Small Areas,OASA,239,179,60
282800,W00000026,W00000026,Output Areas and Small Areas,OASA,239,165,74
282801,W00000027,W00000027,Output Areas and Small Areas,OASA,322,198,124
282802,W00000028,W00000028,Output Areas and Small Areas,OASA,259,155,104
282803,W00000029,W00000029,Output Areas and Small Areas,OASA,230,141,89
282804,W00000030,W00000030,Output Areas and Small Areas,OASA,326,216,110
282805,W00000031,W00000031,Output Areas and Small Areas,OASA,309,233,76
282806,W00000032,W00000032,Output Areas and Small Areas,OASA,206,157,49
282807,W00000033,W00000033,Output Areas and Small Areas,OASA,261,167,94
282808,W00000034,W00000034,Output Areas and Small Areas,OASA,232,162,70
282809,W00000035,W00000035,Output Areas and Small Areas,OASA,344,255,89
282810,W00000036,W00000036,Output Areas and Small Areas,OASA,222,155,67
282811,W00000037,W00000037,Output Areas and Small Areas,OASA,376,258,118
282812,W00000038,W00000038,Output Areas and Small Areas,OASA,344,223,121
282813,W00000039,W00000039,Output Areas and Small Areas,OASA,321,203,118
282814,W00000040,W00000040,Output Areas and Small Areas,OASA,272,178,94
282815,W00000041,W00000041,Output Areas and Small Areas,OASA,230,193,37
282816,W00000042,W00000042,Output Areas and Small Areas,OASA,235,89,146
282817,W00000043,W00000043,Output Areas and Small Areas,OASA,249,77,172
282818,W00000044,W00000044,Output Areas and Small Areas,OASA,424,221,203
282819,W00000045,W00000045,Output Areas and Small Areas,OASA,253,111,142
282820,W00000046,W00000046,Output Areas and Small Areas,OASA,215,105,110
282821,W00000047,W00000047,Output Areas and Small Areas,OASA,239,104,135
282822,W00000048,W00000048,Output Areas and Small Areas,OASA,298,126,172
282823,W00000049,W00000049,Output Areas and Small Areas,OASA,295,116,179
282824,W00000050,W00000050,Output Areas and Small Areas,OASA,227,95,132
282825,W00000051,W00000051,Output Areas and Small Areas,OASA,283,158,125
282826,W00000052,W00000052,Output Areas and Small Areas,OASA,231,186,45
282827,W00000053,W00000053,Output Areas and Small Areas,OASA,339,285,54
282828,W00000054,W00000054,Output Areas and Small Areas,OASA,225,172,53
282829,W00000055,W00000055,Output Areas and Small Areas,OASA,233,172,61
282830,W00000056,W00000056,Output Areas and Small Areas,OASA,214,158,56
282831,W00000057,W00000057,Output Areas and Small Areas,OASA,300,170,130
282832,W00000058,W00000058,Output Areas and Small Areas,OASA,290,125,165
282833,W00000059,W00000059,Output Areas and Small Areas,OASA,250,160,90
282834,W00000060,W00000060,Output Areas and Small Areas,OASA,220,104,116
282835,W00000061,W00000061,Output Areas and Small Areas,OASA,255,148,107
282836,W00000062,W00000062,Output Areas and Small Areas,OASA,318,173,145
282837,W00000063,W00000063,Output Areas and Small Areas,OASA,245,120,125
282838,W00000064,W00000064,Output Areas and Small Areas,OASA,216,191,25
282839,W00000065,W00000065,Output Areas and Small Areas,OASA,219,175,44
282840,W00000066,W00000066,Output Areas and Small Areas,OASA,227,193,34
282841,W00000067,W00000067,Output Areas and Small Areas,OASA,387,292,95
282842,W00000068,W00000068,Output Areas and Small Areas,OASA,333,239,94
282843,W00000069,W00000069,Output Areas and Small Areas,OASA,274,228,46
282844,W00000070,W00000070,Output Areas and Small Areas,OASA,356,261,95
282845,W00000071,W00000071,Output Areas and Small Areas,OASA,348,205,143
282846,W00000072,W00000072,Output Areas and Small Areas,OASA,247,196,51
282847,W00000073,W00000073,Output Areas and Small Areas,OASA,208,119,89
282848,W00000074,W00000074,Output Areas and Small Areas,OASA,186,137,49
282849,W00000075,W00000075,Output Areas and Small Areas,OASA,210,85,125
282850,W00000076,W00000076,Output Areas and Small Areas,OASA,240,86,154
282851,W00000077,W00000077,Output Areas and Small Areas,OASA,309,98,211
282852,W00000078,W00000078,Output Areas and Small Areas,OASA,206,80,126
282853,W00000079,W00000079,Output Areas and Small Areas,OASA,226,80,146
282854,W00000080,W00000080,Output Areas and Small Areas,OASA,223,70,153
282855,W00000081,W00000081,Output Areas and Small Areas,OASA,263,118,145
282856,W00000082,W00000082,Output Areas and Small Areas,OASA,228,111,117
282857,W00000083,W00000083,Output Areas and Small Areas,OASA,283,127,156
282858,W00000084,W00000084,Output Areas and Small Areas,OASA,156,65,91
282859,W00000086,W00000086,Output Areas and Small Areas,OASA,179,87,92
282860,W00000087,W00000087,Output Areas and Small Areas,OASA,190,89,101
282861,W00000088,W00000088,Output Areas and Small Areas,OASA,232,112,120
282862,W00000090,W00000090,Output Areas and Small Areas,OASA,134,81,53
282863,W00000091,W00000091,Output Areas and Small Areas,OASA,276,146,130
282864,W00000092,W00000092,Output Areas and Small Areas,OASA,207,55,152
282865,W00000093,W00000093,Output Areas and Small Areas,OASA,204,75,129
282866,W00000094,W00000094,Output Areas and Small Areas,OASA,277,96,181
282867,W00000095,W00000095,Output Areas and Small Areas,OASA,204,60,144
282868,W00000096,W00000096,Output Areas and Small Areas,OASA,172,86,86
282869,W00000097,W00000097,Output Areas and Small Areas,OASA,312,189,123
282870,W00000098,W00000098,Output Areas and Small Areas,OASA,264,169,95
282871,W00000099,W00000099,Output Areas and Small Areas,OASA,310,229,81
282872,W00000100,W00000100,Output Areas and Small Areas,OASA,237,95,142
282873,W00000101,W00000101,Output Areas and Small Areas,OASA,244,128,116
282874,W00000102,W00000102,Output Areas and Small Areas,OASA,248,107,141
282875,W00000103,W00000103,Output Areas and Small Areas,OASA,273,141,132
282876,W00000104,W00000104,Output Areas and Small Areas,OASA,246,151,95
282877,W00000105,W00000105,Output Areas and Small Areas,OASA,327,192,135
282878,W00000106,W00000106,Output Areas and Small Areas,OASA,277,169,108
282879,W00000107,W00000107,Output Areas and Small Areas,OASA,313,170,143
282880,W00000108,W00000108,Output Areas and Small Areas,OASA,430,239,191
282881,W00000109,W00000109,Output Areas and Small Areas,OASA,203,144,59
282882,W00000110,W00000110,Output Areas and Small Areas,OASA,279,158,121
282883,W00000111,W00000111,Output Areas and Small Areas,OASA,236,130,106
282884,W00000112,W00000112,Output Areas and Small Areas,OASA,210,141,69
282885,W00000113,W00000113,Output Areas and Small Areas,OASA,244,184,60
282886,W00000114,W00000114,Output Areas and Small Areas,OASA,262,174,88
282887,W00000115,W00000115,Output Areas and Small Areas,OASA,364,243,121
282888,W00000116,W00000116,Output Areas and Small Areas,OASA,252,96,156
282889,W00000117,W00000117,Output Areas and Small Areas,OASA,281,58,223
282890,W00000118,W00000118,Output Areas and Small Areas,OASA,262,123,139
282891,W00000119,W00000119,Output Areas and Small Areas,OASA,305,71,234
282892,W00000120,W00000120,Output Areas and Small Areas,OASA,297,162,135
282893,W00000121,W00000121,Output Areas and Small Areas,OASA,241,183,58
282894,W00000122,W00000122,Output Areas and Small Areas,OASA,234,191,43
282895,W00000123,W00000123,Output Areas and Small Areas,OASA,255,185,70
282896,W00000124,W00000124,Output Areas and Small Areas,OASA,338,224,114
282897,W00000125,W00000125,Output Areas and Small Areas,OASA,234,184,50
282898,W00000126,W00000126,Output Areas and Small Areas,OASA,373,263,110
282899,W00000127,W00000127,Output Areas and Small Areas,OASA,277,153,124
282900,W00000128,W00000128,Output Areas and Small Areas,OASA,194,112,82
282901,W00000129,W00000129,Output Areas and Small Areas,OASA,262,84,178
282902,W00000130,W00000130,Output Areas and Small Areas,OASA,156,71,85
282903,W00000131,W00000131,Output Areas and Small Areas,OASA,194,61,133
282904,W00000132,W00000132,Output Areas and Small Areas,OASA,251,136,115
282905,W00000133,W00000133,Output Areas and Small Areas,OASA,381,244,137
282906,W00000134,W00000134,Output Areas and Small Areas,OASA,292,193,99
282907,W00000135,W00000135,Output Areas and Small Areas,OASA,340,191,149
282908,W00000136,W00000136,Output Areas and Small Areas,OASA,258,192,66
282909,W00000137,W00000137,Output Areas and Small Areas,OASA,186,114,72
282910,W00000138,W00000138,Output Areas and Small Areas,OASA,257,196,61
282911,W00000139,W00000139,Output Areas and Small Areas,OASA,329,247,82
282912,W00000140,W00000140,Output Areas and Small Areas,OASA,336,231,105
282913,W00000141,W00000141,Output Areas and Small Areas,OASA,231,140,91
282914,W00000142,W00000142,Output Areas and Small Areas,OASA,247,135,112
282915,W00000143,W00000143,Output Areas and Small Areas,OASA,235,106,129
282916,W00000144,W00000144,Output Areas and Small Areas,OASA,219,85,134
282917,W00000145,W00000145,Output Areas and Small Areas,OASA,291,143,148
282918,W00000146,W00000146,Output Areas and Small Areas,OASA,236,101,135
282919,W00000147,W00000147,Output Areas and Small Areas,OASA,210,85,125
282920,W00000148,W00000148,Output Areas and Small Areas,OASA,137,63,74
282921,W00000149,W00000149,Output Areas and Small Areas,OASA,225,102,123
282922,W00000150,W00000150,Output Areas and Small Areas,OASA,293,124,169
282923,W00000151,W00000151,Output Areas and Small Areas,OASA,238,88,150
282924,W00000152,W00000152,Output Areas and Small Areas,OASA,238,98,140
282925,W00000153,W00000153,Output Areas and Small Areas,OASA,203,79,124
282926,W00000154,W00000154,Output Areas and Small Areas,OASA,207,59,148
282927,W00000155,W00000155,Output Areas and Small Areas,OASA,251,85,166
282928,W00000156,W00000156,Output Areas and Small Areas,OASA,224,126,98
282929,W00000157,W00000157,Output Areas and Small Areas,OASA,293,151,142
282930,W00000158,W00000158,Output Areas and Small Areas,OASA,299,142,157
282931,W00000159,W00000159,Output Areas and Small Areas,OASA,243,144,99
282932,W00000160,W00000160,Output Areas and Small Areas,OASA,230,163,67
282933,W00000161,W00000161,Output Areas and Small Areas,OASA,192,81,111
282934,W00000162,W00000162,Output Areas and Small Areas,OASA,204,127,77
282935,W00000163,W00000163,Output Areas and Small Areas,OASA,296,142,154
282936,W00000164,W00000164,Output Areas and Small Areas,OASA,211,77,134
282937,W00000165,W00000165,Output Areas and Small Areas,OASA,243,106,137
282938,W00000166,W00000166,Output Areas and Small Areas,OASA,235,83,152
282939,W00000167,W00000167,Output Areas and Small Areas,OASA,267,119,148
282940,W00000168,W00000168,Output Areas and Small Areas,OASA,222,73,149
282941,W00000169,W00000169,Output Areas and Small Areas,OASA,246,95,151
282942,W00000170,W00000170,Output Areas and Small Areas,OASA,219,115,104
282943,W00000171,W00000171,Output Areas and Small Areas,OASA,303,133,170
282944,W00000172,W00000172,Output Areas and Small Areas,OASA,218,108,110
282945,W00000173,W00000173,Output Areas and Small Areas,OASA,218,104,114
282946,W00000174,W00000174,Output Areas and Small Areas,OASA,244,122,122
282947,W00000175,W00000175,Output Areas and Small Areas,OASA,334,164,170
282948,W00000176,W00000176,Output Areas and Small Areas,OASA,234,149,85
282949,W00000177,W00000177,Output Areas and Small Areas,OASA,215,112,103
282950,W00000178,W00000178,Output Areas and Small Areas,OASA,275,139,136
282951,W00000179,W00000179,Output Areas and Small Areas,OASA,259,115,144
282952,W00000180,W00000180,Output Areas and Small Areas,OASA,230,104,126
282953,W00000181,W00000181,Output Areas and Small Areas,OASA,205,76,129
282954,W00000182,W00000182,Output Areas and Small Areas,OASA,199,86,113
282955,W00000183,W00000183,Output Areas and Small Areas,OASA,271,96,175
282956,W00000184,W00000184,Output Areas and Small Areas,OASA,253,103,150
282957,W00000185,W00000185,Output Areas and Small Areas,OASA,246,101,145
282958,W00000186,W00000186,Output Areas and Small Areas,OASA,224,68,156
282959,W00000187,W00000187,Output Areas and Small Areas,OASA,229,85,144
282960,W00000188,W00000188,Output Areas and Small Areas,OASA,182,58,124
282961,W00000189,W00000189,Output Areas and Small Areas,OASA,234,108,126
282962,W00000190,W00000190,Output Areas and Small Areas,OASA,224,58,166
282963,W00000191,W00000191,Output Areas and Small Areas,OASA,232,61,171
282964,W00000192,W00000192,Output Areas and Small Areas,OASA,267,140,127
282965,W00000193,W00000193,Output Areas and Small Areas,OASA,216,142,74
282966,W00000194,W00000194,Output Areas and Small Areas,OASA,331,156,175
282967,W00000195,W00000195,Output Areas and Small Areas,OASA,295,182,113
282968,W00000196,W00000196,Output Areas and Small Areas,OASA,244,132,112
282969,W00000197,W00000197,Output Areas and Small Areas,OASA,270,164,106
282970,W00000198,W00000198,Output Areas and Small Areas,OASA,234,110,124
282971,W00000199,W00000199,Output Areas and Small Areas,OASA,177,60,117
282972,W00000200,W00000200,Output Areas and Small Areas,OASA,294,143,151
282973,W00000201,W00000201,Output Areas and Small Areas,OASA,125,33,92
282974,W00000202,W00000202,Output Areas and Small Areas,OASA,300,96,204
282975,W00000203,W00000203,Output Areas and Small Areas,OASA,263,98,165
282976,W00000204,W00000204,Output Areas and Small Areas,OASA,178,50,128
282977,W00000205,W00000205,Output Areas and Small Areas,OASA,162,48,114
282978,W00000206,W00000206,Output Areas and Small Areas,OASA,241,76,165
282979,W00000207,W00000207,Output Areas and Small Areas,OASA,211,82,129
282980,W00000208,W00000208,Output Areas and Small Areas,OASA,284,203,81
282981,W00000209,W00000209,Output Areas and Small Areas,OASA,171,144,27
282982,W00000210,W00000210,Output Areas and Small Areas,OASA,337,260,77
282983,W00000211,W00000211,Output Areas and Small Areas,OASA,111,94,17
282984,W00000212,W00000212,Output Areas and Small Areas,OASA,265,217,48
282985,W00000213,W00000213,Output Areas and Small Areas,OASA,278,137,141
282986,W00000214,W00000214,Output Areas and Small Areas,OASA,272,153,119
282987,W00000215,W00000215,Output Areas and Small Areas,OASA,247,125,122
282988,W00000216,W00000216,Output Areas and Small Areas,OASA,244,156,88
282989,W00000217,W00000217,Output Areas and Small Areas,OASA,228,124,104
282990,W00000218,W00000218,Output Areas and Small Areas,OASA,230,131,99
282991,W00000219,W00000219,Output Areas and Small Areas,OASA,249,151,98
282992,W00000220,W00000220,Output Areas and Small Areas,OASA,279,187,92
282993,W00000221,W00000221,Output Areas and Small Areas,OASA,235,125,110
282994,W00000222,W00000222,Output Areas and Small Areas,OASA,214,122,92
282995,W00000223,W00000223,Output Areas and Small Areas,OASA,268,128,140
282996,W00000224,W00000224,Output Areas and Small Areas,OASA,253,121,132
282997,W00000225,W00000225,Output Areas and Small Areas,OASA,240,113,127
282998,W00000226,W00000226,Output Areas and Small Areas,OASA,255,107,148
282999,W00000227,W00000227,Output Areas and Small Areas,OASA,206,98,108
283000,W00000228,W00000228,Output Areas and Small Areas,OASA,248,190,58
283001,W00000229,W00000229,Output Areas and Small Areas,OASA,308,215,93
283002,W00000230,W00000230,Output Areas and Small Areas,OASA,260,177,83
283003,W00000231,W00000231,Output Areas and Small Areas,OASA,238,51,187
283004,W00000232,W00000232,Output Areas and Small Areas,OASA,239,64,175
283005,W00000233,W00000233,Output Areas and Small Areas,OASA,133,48,85
283006,W00000234,W00000234,Output Areas and Small Areas,OASA,197,45,152
283007,W00000235,W00000235,Output Areas and Small Areas,OASA,353,148,205
283008,W00000236,W00000236,Output Areas and Small Areas,OASA,252,186,66
283009,W00000237,W00000237,Output Areas and Small Areas,OASA,229,187,42
283010,W00000238,W00000238,Output Areas and Small Areas,OASA,223,190,33
283011,W00000239,W00000239,Output Areas and Small Areas,OASA,218,148,70
283012,W00000240,W00000240,Output Areas and Small Areas,OASA,175,128,47
283013,W00000241,W00000241,Output Areas and Small Areas,OASA,249,89,160
283014,W00000242,W00000242,Output Areas and Small Areas,OASA,228,78,150
283015,W00000243,W00000243,Output Areas and Small Areas,OASA,212,84,128
283016,W00000244,W00000244,Output Areas and Small Areas,OASA,262,78,184
283017,W00000245,W00000245,Output Areas and Small Areas,OASA,215,72,143
283018,W00000246,W00000246,Output Areas and Small Areas,OASA,280,76,204
283019,W00000247,W00000247,Output Areas and Small Areas,OASA,227,97,130
283020,W00000248,W00000248,Output Areas and Small Areas,OASA,193,72,121
283021,W00000249,W00000249,Output Areas and Small Areas,OASA,223,83,140
283022,W00000250,W00000250,Output Areas and Small Areas,OASA,189,56,133
283023,W00000251,W00000251,Output Areas and Small Areas,OASA,151,65,86
283024,W00000252,W00000252,Output Areas and Small Areas,OASA,181,76,105
283025,W00000253,W00000253,Output Areas and Small Areas,OASA,174,70,104
283026,W00000254,W00000254,Output Areas and Small Areas,OASA,200,89,111
283027,W00000255,W00000255,Output Areas and Small Areas,OASA,227,118,109
283028,W00000256,W00000256,Output Areas and Small Areas,OASA,217,133,84
283029,W00000257,W00000257,Output Areas and Small Areas,OASA,137,89,48
283030,W00000258,W00000258,Output Areas and Small Areas,OASA,341,209,132
283031,W00000259,W00000259,Output Areas and Small Areas,OASA,234,178,56
283032,W00000260,W00000260,Output Areas and Small Areas,OASA,233,173,60
283033,W00000261,W00000261,Output Areas and Small Areas,OASA,200,143,57
283034,W00000262,W00000262,Output Areas and Small Areas,OASA,276,212,64
283035,W00000263,W00000263,Output Areas and Small Areas,OASA,251,193,58
283036,W00000264,W00000264,Output Areas and Small Areas,OASA,208,159,49
283037,W00000265,W00000265,Output Areas and Small Areas,OASA,235,186,49
283038,W00000266,W00000266,Output Areas and Small Areas,OASA,240,213,27
283039,W00000267,W00000267,Output Areas and Small Areas,OASA,239,187,52
283040,W00000268,W00000268,Output Areas and Small Areas,OASA,175,154,21
283041,W00000269,W00000269,Output Areas and Small Areas,OASA,177,131,46
283042,W00000270,W00000270,Output Areas and Small Areas,OASA,276,237,39
283043,W00000271,W00000271,Output Areas and Small Areas,OASA,318,253,65
283044,W00000272,W00000272,Output Areas and Small Areas,OASA,203,179,24
283045,W00000273,W00000273,Output Areas and Small Areas,OASA,268,237,31
283046,W00000274,W00000274,Output Areas and Small Areas,OASA,166,110,56
283047,W00000275,W00000275,Output Areas and Small Areas,OASA,286,187,99
283048,W00000276,W00000276,Output Areas and Small Areas,OASA,238,195,43
283049,W00000277,W00000277,Output Areas and Small Areas,OASA,265,185,80
283050,W00000278,W00000278,Output Areas and Small Areas,OASA,279,173,106
283051,W00000279,W00000279,Output Areas and Small Areas,OASA,292,224,68
283052,W00000280,W00000280,Output Areas and Small Areas,OASA,225,181,44
283053,W00000281,W00000281,Output Areas and Small Areas,OASA,252,227,25
283054,W00000282,W00000282,Output Areas and Small Areas,OASA,202,164,38
283055,W00000283,W00000283,Output Areas and Small Areas,OASA,266,177,89
283056,W00000284,W00000284,Output Areas and Small Areas,OASA,190,120,70
283057,W00000285,W00000285,Output Areas and Small Areas,OASA,194,99,95
283058,W00000286,W00000286,Output Areas and Small Areas,OASA,258,186,72
283059,W00000287,W00000287,Output Areas and Small Areas,OASA,146,84,62
283060,W00000288,W00000288,Output Areas and Small Areas,OASA,160,78,82
283061,W00000289,W00000289,Output Areas and Small Areas,OASA,282,156,126
283062,W00000290,W00000290,Output Areas and Small Areas,OASA,265,130,135
283063,W00000291,W00000291,Output Areas and Small Areas,OASA,276,131,145
283064,W00000292,W00000292,Output Areas and Small Areas,OASA,293,132,161
283065,W00000293,W00000293,Output Areas and Small Areas,OASA,189,144,45
283066,W00000294,W00000294,Output Areas and Small Areas,OASA,202,177,25
283067,W00000295,W00000295,Output Areas and Small Areas,OASA,164,134,30
283068,W00000296,W00000296,Output Areas and Small Areas,OASA,212,185,27
283069,W00000297,W00000297,Output Areas and Small Areas,OASA,230,210,20
283070,W00000298,W00000298,Output Areas and Small Areas,OASA,269,238,31
283071,W00000299,W00000299,Output Areas and Small Areas,OASA,197,162,35
283072,W00000300,W00000300,Output Areas and Small Areas,OASA,190,145,45
283073,W00000301,W00000301,Output Areas and Small Areas,OASA,272,188,84
283074,W00000302,W00000302,Output Areas and Small Areas,OASA,286,199,87
283075,W00000303,W00000303,Output Areas and Small Areas,OASA,242,169,73
283076,W00000304,W00000304,Output Areas and Small Areas,OASA,307,129,178
283077,W00000305,W00000305,Output Areas and Small Areas,OASA,260,127,133
283078,W00000306,W00000306,Output Areas and Small Areas,OASA,261,147,114
283079,W00000307,W00000307,Output Areas and Small Areas,OASA,278,154,124
283080,W00000308,W00000308,Output Areas and Small Areas,OASA,217,117,100
283081,W00000309,W00000309,Output Areas and Small Areas,OASA,237,144,93
283082,W00000310,W00000310,Output Areas and Small Areas,OASA,266,191,75
283083,W00000311,W00000311,Output Areas and Small Areas,OASA,231,106,125
283084,W00000312,W00000312,Output Areas and Small Areas,OASA,303,222,81
283085,W00000313,W00000313,Output Areas and Small Areas,OASA,240,122,118
283086,W00000314,W00000314,Output Areas and Small Areas,OASA,296,220,76
283087,W00000315,W00000315,Output Areas and Small Areas,OASA,259,180,79
283088,W00000316,W00000316,Output Areas and Small Areas,OASA,246,158,88
283089,W00000317,W00000317,Output Areas and Small Areas,OASA,238,64,174
283090,W00000318,W00000318,Output Areas and Small Areas,OASA,274,78,196
283091,W00000319,W00000319,Output Areas and Small Areas,OASA,325,55,270
283092,W00000320,W00000320,Output Areas and Small Areas,OASA,228,61,167
283093,W00000322,W00000322,Output Areas and Small Areas,OASA,242,194,48
283094,W00000323,W00000323,Output Areas and Small Areas,OASA,292,253,39
283095,W00000324,W00000324,Output Areas and Small Areas,OASA,267,205,62
283096,W00000325,W00000325,Output Areas and Small Areas,OASA,222,129,93
283097,W00000326,W00000326,Output Areas and Small Areas,OASA,255,178,77
283098,W00000327,W00000327,Output Areas and Small Areas,OASA,199,84,115
283099,W00000328,W00000328,Output Areas and Small Areas,OASA,257,105,152
283100,W00000329,W00000329,Output Areas and Small Areas,OASA,264,121,143
283101,W00000330,W00000330,Output Areas and Small Areas,OASA,301,182,119
283102,W00000331,W00000331,Output Areas and Small Areas,OASA,373,166,207
283103,W00000332,W00000332,Output Areas and Small Areas,OASA,240,131,109
283104,W00000333,W00000333,Output Areas and Small Areas,OASA,245,184,61
283105,W00000334,W00000334,Output Areas and Small Areas,OASA,232,202,30
283106,W00000335,W00000335,Output Areas and Small Areas,OASA,244,168,76
283107,W00000336,W00000336,Output Areas and Small Areas,OASA,228,176,52
283108,W00000337,W00000337,Output Areas and Small Areas,OASA,273,212,61
283109,W00000338,W00000338,Output Areas and Small Areas,OASA,234,148,86
283110,W00000339,W00000339,Output Areas and Small Areas,OASA,278,174,104
283111,W00000340,W00000340,Output Areas and Small Areas,OASA,222,106,116
283112,W00000341,W00000341,Output Areas and Small Areas,OASA,226,116,110
283113,W00000342,W00000342,Output Areas and Small Areas,OASA,231,162,69
283114,W00000343,W00000343,Output Areas and Small Areas,OASA,243,147,96
283115,W00000344,W00000344,Output Areas and Small Areas,OASA,195,123,72
283116,W00000345,W00000345,Output Areas and Small Areas,OASA,152,71,81
283117,W00000346,W00000346,Output Areas and Small Areas,OASA,259,185,74
283118,W00000347,W00000347,Output Areas and Small Areas,OASA,207,120,87
283119,W00000348,W00000348,Output Areas and Small Areas,OASA,309,169,140
283120,W00000349,W00000349,Output Areas and Small Areas,OASA,239,167,72
283121,W00000350,W00000350,Output Areas and Small Areas,OASA,183,106,77
283122,W00000351,W00000351,Output Areas and Small Areas,OASA,224,85,139
283123,W00000352,W00000352,Output Areas and Small Areas,OASA,234,109,125
283124,W00000353,W00000353,Output Areas and Small Areas,OASA,229,67,162
283125,W00000354,W00000354,Output Areas and Small Areas,OASA,245,151,94
283126,W00000355,W00000355,Output Areas and Small Areas,OASA,225,97,128
283127,W00000356,W00000356,Output Areas and Small Areas,OASA,191,70,121
283128,W00000357,W00000357,Output Areas and Small Areas,OASA,399,284,115
283129,W00000358,W00000358,Output Areas and Small Areas,OASA,216,153,63
283130,W00000359,W00000359,Output Areas and Small Areas,OASA,225,154,71
283131,W00000360,W00000360,Output Areas and Small Areas,OASA,223,168,55
283132,W00000362,W00000362,Output Areas and Small Areas,OASA,329,115,214
283133,W00000363,W00000363,Output Areas and Small Areas,OASA,250,169,81
283134,W00000364,W00000364,Output Areas and Small Areas,OASA,249,154,95
283135,W00000365,W00000365,Output Areas and Small Areas,OASA,240,195,45
283136,W00000366,W00000366,Output Areas and Small Areas,OASA,297,220,77
283137,W00000367,W00000367,Output Areas and Small Areas,OASA,287,203,84
283138,W00000368,W00000368,Output Areas and Small Areas,OASA,279,197,82
283139,W00000369,W00000369,Output Areas and Small Areas,OASA,256,158,98
283140,W00000370,W00000370,Output Areas and Small Areas,OASA,261,139,122
283141,W00000371,W00000371,Output Areas and Small Areas,OASA,250,152,98
283142,W00000372,W00000372,Output Areas and Small Areas,OASA,267,93,174
283143,W00000373,W00000373,Output Areas and Small Areas,OASA,227,83,144
283144,W00000374,W00000374,Output Areas and Small Areas,OASA,243,126,117
283145,W00000375,W00000375,Output Areas and Small Areas,OASA,220,113,107
283146,W00000376,W00000376,Output Areas and Small Areas,OASA,192,145,47
283147,W00000377,W00000377,Output Areas and Small Areas,OASA,225,165,60
283148,W00000378,W00000378,Output Areas and Small Areas,OASA,253,191,62
283149,W00000379,W00000379,Output Areas and Small Areas,OASA,271,238,33
283150,W00000380,W00000380,Output Areas and Small Areas,OASA,230,180,50
283151,W00000381,W00000381,Output Areas and Small Areas,OASA,229,181,48
283152,W00000382,W00000382,Output Areas and Small Areas,OASA,237,70,167
283153,W00000383,W00000383,Output Areas and Small Areas,OASA,267,137,130
283154,W00000384,W00000384,Output Areas and Small Areas,OASA,239,141,98
283155,W00000385,W00000385,Output Areas and Small Areas,OASA,224,94,130
283156,W00000386,W00000386,Output Areas and Small Areas,OASA,282,136,146
283157,W00000387,W00000387,Output Areas and Small Areas,OASA,238,129,109
283158,W00000388,W00000388,Output Areas and Small Areas,OASA,245,151,94
283159,W00000389,W00000389,Output Areas and Small Areas,OASA,216,106,110
283160,W00000390,W00000390,Output Areas and Small Areas,OASA,304,132,172
283161,W00000391,W00000391,Output Areas and Small Areas,OASA,190,86,104
283162,W00000392,W00000392,Output Areas and Small Areas,OASA,219,92,127
283163,W00000393,W00000393,Output Areas and Small Areas,OASA,322,84,238
283164,W00000394,W00000394,Output Areas and Small Areas,OASA,333,106,227
283165,W00000395,W00000395,Output Areas and Small Areas,OASA,275,122,153
283166,W00000396,W00000396,Output Areas and Small Areas,OASA,393,113,280
283167,W00000397,W00000397,Output Areas and Small Areas,OASA,291,85,206
283168,W00000398,W00000398,Output Areas and Small Areas,OASA,215,102,113
283169,W00000399,W00000399,Output Areas and Small Areas,OASA,254,191,63
283170,W00000400,W00000400,Output Areas and Small Areas,OASA,220,165,55
283171,W00000401,W00000401,Output Areas and Small Areas,OASA,214,162,52
283172,W00000402,W00000402,Output Areas and Small Areas,OASA,228,161,67
283173,W00000403,W00000403,Output Areas and Small Areas,OASA,118,93,25
283174,W00000404,W00000404,Output Areas and Small Areas,OASA,337,208,129
283175,W00000405,W00000405,Output Areas and Small Areas,OASA,212,105,107
283176,W00000406,W00000406,Output Areas and Small Areas,OASA,313,158,155
283177,W00000407,W00000407,Output Areas and Small Areas,OASA,132,43,89
283178,W00000408,W00000408,Output Areas and Small Areas,OASA,283,128,155
283179,W00000409,W00000409,Output Areas and Small Areas,OASA,347,104,243
283180,W00000410,W00000410,Output Areas and Small Areas,OASA,278,199,79
283181,W00000411,W00000411,Output Areas and Small Areas,OASA,241,121,120
283182,W00000412,W00000412,Output Areas and Small Areas,OASA,303,233,70
283183,W00000413,W00000413,Output Areas and Small Areas,OASA,141,82,59
283184,W00000414,W00000414,Output Areas and Small Areas,OASA,241,211,30
283185,W00000415,W00000415,Output Areas and Small Areas,OASA,275,195,80
283186,W00000416,W00000416,Output Areas and Small Areas,OASA,248,157,91
283187,W00000417,W00000417,Output Areas and Small Areas,OASA,228,156,72
283188,W00000418,W00000418,Output Areas and Small Areas,OASA,261,187,74
283189,W00000419,W00000419,Output Areas and Small Areas,OASA,328,212,116
283190,W00000420,W00000420,Output Areas and Small Areas,OASA,285,214,71
283191,W00000421,W00000421,Output Areas and Small Areas,OASA,271,127,144
283192,W00000422,W00000422,Output Areas and Small Areas,OASA,347,268,79
283193,W00000423,W00000423,Output Areas and Small Areas,OASA,222,139,83
283194,W00000424,W00000424,Output Areas and Small Areas,OASA,233,122,111
283195,W00000425,W00000425,Output Areas and Small Areas,OASA,282,197,85
283196,W00000426,W00000426,Output Areas and Small Areas,OASA,275,137,138
283197,W00000427,W00000427,Output Areas and Small Areas,OASA,230,42,188
283198,W00000428,W00000428,Output Areas and Small Areas,OASA,201,51,150
283199,W00000429,W00000429,Output Areas and Small Areas,OASA,221,30,191
283200,W00000430,W00000430,Output Areas and Small Areas,OASA,266,89,177
283201,W00000431,W00000431,Output Areas and Small Areas,OASA,255,112,143
283202,W00000432,W00000432,Output Areas and Small Areas,OASA,214,75,139
283203,W00000433,W00000433,Output Areas and Small Areas,OASA,228,61,167
283204,W00000434,W00000434,Output Areas and Small Areas,OASA,128,58,70
283205,W00000435,W00000435,Output Areas and Small Areas,OASA,295,251,44
283206,W00000436,W00000436,Output Areas and Small Areas,OASA,302,192,110
283207,W00000437,W00000437,Output Areas and Small Areas,OASA,227,180,47
283208,W00000438,W00000438,Output Areas and Small Areas,OASA,193,106,87
283209,W00000439,W00000439,Output Areas and Small Areas,OASA,248,222,26
283210,W00000440,W00000440,Output Areas and Small Areas,OASA,202,174,28
283211,W00000441,W00000441,Output Areas and Small Areas,OASA,279,236,43
283212,W00000442,W00000442,Output Areas and Small Areas,OASA,245,218,27
283213,W00000443,W00000443,Output Areas and Small Areas,OASA,254,210,44
283214,W00000444,W00000444,Output Areas and Small Areas,OASA,259,220,39
283215,W00000445,W00000445,Output Areas and Small Areas,OASA,217,138,79
283216,W00000446,W00000446,Output Areas and Small Areas,OASA,244,210,34
283217,W00000447,W00000447,Output Areas and Small Areas,OASA,265,203,62
283218,W00000448,W00000448,Output Areas and Small Areas,OASA,262,181,81
283219,W00000449,W00000449,Output Areas and Small Areas,OASA,263,231,32
283220,W00000450,W00000450,Output Areas and Small Areas,OASA,288,230,58
283221,W00000451,W00000451,Output Areas and Small Areas,OASA,238,180,58
283222,W00000452,W00000452,Output Areas and Small Areas,OASA,241,208,33
283223,W00000453,W00000453,Output Areas and Small Areas,OASA,288,232,56
283224,W00000454,W00000454,Output Areas and Small Areas,OASA,272,219,53
283225,W00000455,W00000455,Output Areas and Small Areas,OASA,302,207,95
283226,W00000456,W00000456,Output Areas and Small Areas,OASA,255,178,77
283227,W00000457,W00000457,Output Areas and Small Areas,OASA,255,195,60
283228,W00000458,W00000458,Output Areas and Small Areas,OASA,279,190,89
283229,W00000459,W00000459,Output Areas and Small Areas,OASA,297,235,62
283230,W00000460,W00000460,Output Areas and Small Areas,OASA,265,105,160
283231,W00000461,W00000461,Output Areas and Small Areas,OASA,164,71,93
283232,W00000462,W00000462,Output Areas and Small Areas,OASA,262,122,140
283233,W00000463,W00000463,Output Areas and Small Areas,OASA,247,115,132
283234,W00000464,W00000464,Output Areas and Small Areas,OASA,267,122,145
283235,W00000465,W00000465,Output Areas and Small Areas,OASA,222,105,117
283236,W00000466,W00000466,Output Areas and Small Areas,OASA,266,135,131
283237,W00000467,W00000467,Output Areas and Small Areas,OASA,257,99,158
283238,W00000468,W00000468,Output Areas and Small Areas,OASA,510,111,399
283239,W00000469,W00000469,Output Areas and Small Areas,OASA,450,89,361
283240,W00000470,W00000470,Output Areas and Small Areas,OASA,392,78,314
283241,W00000472,W00000472,Output Areas and Small Areas,OASA,423,66,357
283242,W00000473,W00000473,Output Areas and Small Areas,OASA,215,152,63
283243,W00000474,W00000474,Output Areas and Small Areas,OASA,253,209,44
283244,W00000475,W00000475,Output Areas and Small Areas,OASA,312,257,55
283245,W00000476,W00000476,Output Areas and Small Areas,OASA,297,223,74
283246,W00000477,W00000477,Output Areas and Small Areas,OASA,232,212,20
283247,W00000478,W00000478,Output Areas and Small Areas,OASA,188,167,21
283248,W00000479,W00000479,Output Areas and Small Areas,OASA,184,154,30
283249,W00000480,W00000480,Output Areas and Small Areas,OASA,223,194,29
283250,W00000481,W00000481,Output Areas and Small Areas,OASA,268,202,66
283251,W00000482,W00000482,Output Areas and Small Areas,OASA,314,229,85
283252,W00000483,W00000483,Output Areas and Small Areas,OASA,212,127,85
283253,W00000484,W00000484,Output Areas and Small Areas,OASA,236,145,91
283254,W00000485,W00000485,Output Areas and Small Areas,OASA,224,178,46
283255,W00000486,W00000486,Output Areas and Small Areas,OASA,205,151,54
283256,W00000487,W00000487,Output Areas and Small Areas,OASA,212,147,65
283257,W00000488,W00000488,Output Areas and Small Areas,OASA,231,171,60
283258,W00000489,W00000489,Output Areas and Small Areas,OASA,227,150,77
283259,W00000490,W00000490,Output Areas and Small Areas,OASA,238,196,42
283260,W00000491,W00000491,Output Areas and Small Areas,OASA,240,160,80
283261,W00000492,W00000492,Output Areas and Small Areas,OASA,252,215,37
283262,W00000493,W00000493,Output Areas and Small Areas,OASA,194,146,48
283263,W00000494,W00000494,Output Areas and Small Areas,OASA,247,180,67
283264,W00000495,W00000495,Output Areas and Small Areas,OASA,223,169,54
283265,W00000496,W00000496,Output Areas and Small Areas,OASA,263,223,40
283266,W00000497,W00000497,Output Areas and Small Areas,OASA,252,218,34
283267,W00000498,W00000498,Output Areas and Small Areas,OASA,206,180,26
283268,W00000499,W00000499,Output Areas and Small Areas,OASA,251,230,21
283269,W00000500,W00000500,Output Areas and Small Areas,OASA,281,222,59
283270,W00000501,W00000501,Output Areas and Small Areas,OASA,250,202,48
283271,W00000502,W00000502,Output Areas and Small Areas,OASA,242,216,26
283272,W00000503,W00000503,Output Areas and Small Areas,OASA,232,202,30
283273,W00000504,W00000504,Output Areas and Small Areas,OASA,225,194,31
283274,W00000505,W00000505,Output Areas and Small Areas,OASA,244,158,86
283275,W00000506,W00000506,Output Areas and Small Areas,OASA,320,226,94
283276,W00000507,W00000507,Output Areas and Small Areas,OASA,196,153,43
283277,W00000508,W00000508,Output Areas and Small Areas,OASA,349,223,126
283278,W00000509,W00000509,Output Areas and Small Areas,OASA,308,187,121
283279,W00000510,W00000510,Output Areas and Small Areas,OASA,157,93,64
283280,W00000511,W00000511,Output Areas and Small Areas,OASA,208,146,62
283281,W00000512,W00000512,Output Areas and Small Areas,OASA,278,187,91
283282,W00000513,W00000513,Output Areas and Small Areas,OASA,245,187,58
283283,W00000514,W00000514,Output Areas and Small Areas,OASA,243,174,69
283284,W00000515,W00000515,Output Areas and Small Areas,OASA,223,175,48
283285,W00000516,W00000516,Output Areas and Small Areas,OASA,247,176,71
283286,W00000517,W00000517,Output Areas and Small Areas,OASA,209,148,61
283287,W00000518,W00000518,Output Areas and Small Areas,OASA,249,156,93
283288,W00000519,W00000519,Output Areas and Small Areas,OASA,306,142,164
283289,W00000520,W00000520,Output Areas and Small Areas,OASA,334,199,135
283290,W00000521,W00000521,Output Areas and Small Areas,OASA,198,100,98
283291,W00000522,W00000522,Output Areas and Small Areas,OASA,252,140,112
283292,W00000523,W00000523,Output Areas and Small Areas,OASA,223,122,101
283293,W00000524,W00000524,Output Areas and Small Areas,OASA,382,221,161
283294,W00000525,W00000525,Output Areas and Small Areas,OASA,306,200,106
283295,W00000526,W00000526,Output Areas and Small Areas,OASA,265,224,41
283296,W00000527,W00000527,Output Areas and Small Areas,OASA,222,190,32
283297,W00000528,W00000528,Output Areas and Small Areas,OASA,269,233,36
283298,W00000529,W00000529,Output Areas and Small Areas,OASA,224,194,30
283299,W00000530,W00000530,Output Areas and Small Areas,OASA,245,209,36
283300,W00000531,W00000531,Output Areas and Small Areas,OASA,237,197,40
283301,W00000532,W00000532,Output Areas and Small Areas,OASA,214,175,39
283302,W00000533,W00000533,Output Areas and Small Areas,OASA,255,205,50
283303,W00000534,W00000534,Output Areas and Small Areas,OASA,211,153,58
283304,W00000535,W00000535,Output Areas and Small Areas,OASA,260,203,57
283305,W00000536,W00000536,Output Areas and Small Areas,OASA,210,162,48
283306,W00000537,W00000537,Output Areas and Small Areas,OASA,268,207,61
283307,W00000538,W00000538,Output Areas and Small Areas,OASA,163,64,99
283308,W00000539,W00000539,Output Areas and Small Areas,OASA,276,127,149
283309,W00000540,W00000540,Output Areas and Small Areas,OASA,156,76,80
283310,W00000541,W00000541,Output Areas and Small Areas,OASA,288,176,112
283311,W00000542,W00000542,Output Areas and Small Areas,OASA,215,112,103
283312,W00000543,W00000543,Output Areas and Small Areas,OASA,206,93,113
283313,W00000544,W00000544,Output Areas and Small Areas,OASA,254,188,66
283314,W00000545,W00000545,Output Areas and Small Areas,OASA,200,111,89
283315,W00000546,W00000546,Output Areas and Small Areas,OASA,202,83,119
283316,W00000547,W00000547,Output Areas and Small Areas,OASA,107,72,35
283317,W00000548,W00000548,Output Areas and Small Areas,OASA,316,246,70
283318,W00000549,W00000549,Output Areas and Small Areas,OASA,239,164,75
283319,W00000550,W00000550,Output Areas and Small Areas,OASA,245,179,66
283320,W00000551,W00000551,Output Areas and Small Areas,OASA,305,239,66
283321,W00000552,W00000552,Output Areas and Small Areas,OASA,300,208,92
283322,W00000553,W00000553,Output Areas and Small Areas,OASA,234,180,54
283323,W00000554,W00000554,Output Areas and Small Areas,OASA,233,191,42
283324,W00000555,W00000555,Output Areas and Small Areas,OASA,218,159,59
283325,W00000556,W00000556,Output Areas and Small Areas,OASA,230,192,38
283326,W00000557,W00000557,Output Areas and Small Areas,OASA,224,186,38
283327,W00000558,W00000558,Output Areas and Small Areas,OASA,178,105,73
283328,W00000559,W00000559,Output Areas and Small Areas,OASA,213,161,52
283329,W00000560,W00000560,Output Areas and Small Areas,OASA,245,195,50
283330,W00000561,W00000561,Output Areas and Small Areas,OASA,219,147,72
283331,W00000562,W00000562,Output Areas and Small Areas,OASA,232,191,41
283332,W00000563,W00000563,Output Areas and Small Areas,OASA,254,197,57
283333,W00000564,W00000564,Output Areas and Small Areas,OASA,212,140,72
283334,W00000565,W00000565,Output Areas and Small Areas,OASA,163,110,53
283335,W00000566,W00000566,Output Areas and Small Areas,OASA,226,184,42
283336,W00000567,W00000567,Output Areas and Small Areas,OASA,163,132,31
283337,W00000568,W00000568,Output Areas and Small Areas,OASA,184,163,21
283338,W00000569,W00000569,Output Areas and Small Areas,OASA,271,235,36
283339,W00000570,W00000570,Output Areas and Small Areas,OASA,203,176,27
283340,W00000571,W00000571,Output Areas and Small Areas,OASA,232,208,24
283341,W00000572,W00000572,Output Areas and Small Areas,OASA,196,178,18
283342,W00000573,W00000573,Output Areas and Small Areas,OASA,248,238,10
283343,W00000574,W00000574,Output Areas and Small Areas,OASA,255,215,40
283344,W00000575,W00000575,Output Areas and Small Areas,OASA,108,84,24
283345,W00000576,W00000576,Output Areas and Small Areas,OASA,216,115,101
283346,W00000577,W00000577,Output Areas and Small Areas,OASA,200,125,75
283347,W00000578,W00000578,Output Areas and Small Areas,OASA,260,207,53
283348,W00000579,W00000579,Output Areas and Small Areas,OASA,320,226,94
283349,W00000580,W00000580,Output Areas and Small Areas,OASA,235,159,76
283350,W00000581,W00000581,Output Areas and Small Areas,OASA,290,181,109
283351,W00000582,W00000582,Output Areas and Small Areas,OASA,259,160,99
283352,W00000583,W00000583,Output Areas and Small Areas,OASA,273,203,70
283353,W00000584,W00000584,Output Areas and Small Areas,OASA,244,195,49
283354,W00000585,W00000585,Output Areas and Small Areas,OASA,288,237,51
283355,W00000586,W00000586,Output Areas and Small Areas,OASA,207,158,49
283356,W00000587,W00000587,Output Areas and Small Areas,OASA,249,187,62
283357,W00000588,W00000588,Output Areas and Small Areas,OASA,296,187,109
283358,W00000589,W00000589,Output Areas and Small Areas,OASA,230,142,88
283359,W00000590,W00000590,Output Areas and Small Areas,OASA,256,213,43
283360,W00000591,W00000591,Output Areas and Small Areas,OASA,283,198,85
283361,W00000592,W00000592,Output Areas and Small Areas,OASA,258,176,82
283362,W00000593,W00000593,Output Areas and Small Areas,OASA,231,171,60
283363,W00000594,W00000594,Output Areas and Small Areas,OASA,250,189,61
283364,W00000595,W00000595,Output Areas and Small Areas,OASA,296,199,97
283365,W00000596,W00000596,Output Areas and Small Areas,OASA,270,183,87
283366,W00000597,W00000597,Output Areas and Small Areas,OASA,251,134,117
283367,W00000598,W00000598,Output Areas and Small Areas,OASA,254,137,117
283368,W00000599,W00000599,Output Areas and Small Areas,OASA,227,143,84
283369,W00000600,W00000600,Output Areas and Small Areas,OASA,249,191,58
283370,W00000601,W00000601,Output Areas and Small Areas,OASA,272,169,103
283371,W00000602,W00000602,Output Areas and Small Areas,OASA,260,192,68
283372,W00000603,W00000603,Output Areas and Small Areas,OASA,231,72,159
283373,W00000604,W00000604,Output Areas and Small Areas,OASA,138,70,68
283374,W00000605,W00000605,Output Areas and Small Areas,OASA,194,61,133
283375,W00000606,W00000606,Output Areas and Small Areas,OASA,220,58,162
283376,W00000607,W00000607,Output Areas and Small Areas,OASA,213,58,155
283377,W00000608,W00000608,Output Areas and Small Areas,OASA,217,114,103
283378,W00000609,W00000609,Output Areas and Small Areas,OASA,206,43,163
283379,W00000610,W00000610,Output Areas and Small Areas,OASA,239,53,186
283380,W00000611,W00000611,Output Areas and Small Areas,OASA,246,105,141
283381,W00000612,W00000612,Output Areas and Small Areas,OASA,190,47,143
283382,W00000613,W00000613,Output Areas and Small Areas,OASA,267,85,182
283383,W00000614,W00000614,Output Areas and Small Areas,OASA,212,47,165
283384,W00000615,W00000615,Output Areas and Small Areas,OASA,229,67,162
283385,W00000616,W00000616,Output Areas and Small Areas,OASA,205,99,106
283386,W00000617,W00000617,Output Areas and Small Areas,OASA,197,157,40
283387,W00000618,W00000618,Output Areas and Small Areas,OASA,268,219,49
283388,W00000619,W00000619,Output Areas and Small Areas,OASA,238,148,90
283389,W00000620,W00000620,Output Areas and Small Areas,OASA,242,181,61
283390,W00000621,W00000621,Output Areas and Small Areas,OASA,188,154,34
283391,W00000622,W00000622,Output Areas and Small Areas,OASA,247,202,45
283392,W00000623,W00000623,Output Areas and Small Areas,OASA,243,162,81
283393,W00000624,W00000624,Output Areas and Small Areas,OASA,231,150,81
283394,W00000625,W00000625,Output Areas and Small Areas,OASA,317,230,87
283395,W00000626,W00000626,Output Areas and Small Areas,OASA,299,183,116
283396,W00000627,W00000627,Output Areas and Small Areas,OASA,299,105,194
283397,W00000628,W00000628,Output Areas and Small Areas,OASA,274,142,132
283398,W00000629,W00000629,Output Areas and Small Areas,OASA,231,14,217
283399,W00000630,W00000630,Output Areas and Small Areas,OASA,263,20,243
283400,W00000631,W00000631,Output Areas and Small Areas,OASA,181,15,166
283401,W00000632,W00000632,Output Areas and Small Areas,OASA,341,28,313
283402,W00000633,W00000633,Output Areas and Small Areas,OASA,274,32,242
283403,W00000634,W00000634,Output Areas and Small Areas,OASA,180,14,166
283404,W00000635,W00000635,Output Areas and Small Areas,OASA,243,25,218
283405,W00000636,W00000636,Output Areas and Small Areas,OASA,169,10,159
283406,W00000637,W00000637,Output Areas and Small Areas,OASA,216,19,197
283407,W00000638,W00000638,Output Areas and Small Areas,OASA,254,133,121
283408,W00000639,W00000639,Output Areas and Small Areas,OASA,219,66,153
283409,W00000640,W00000640,Output Areas and Small Areas,OASA,174,95,79
283410,W00000641,W00000641,Output Areas and Small Areas,OASA,223,88,135
283411,W00000642,W00000642,Output Areas and Small Areas,OASA,174,94,80
283412,W00000643,W00000643,Output Areas and Small Areas,OASA,317,143,174
283413,W00000644,W00000644,Output Areas and Small Areas,OASA,313,138,175
283414,W00000645,W00000645,Output Areas and Small Areas,OASA,252,107,145
283415,W00000646,W00000646,Output Areas and Small Areas,OASA,357,126,231
283416,W00000647,W00000647,Output Areas and Small Areas,OASA,285,114,171
283417,W00000648,W00000648,Output Areas and Small Areas,OASA,272,137,135
283418,W00000649,W00000649,Output Areas and Small Areas,OASA,287,144,143
283419,W00000650,W00000650,Output Areas and Small Areas,OASA,216,110,106
283420,W00000651,W00000651,Output Areas and Small Areas,OASA,233,100,133
283421,W00000653,W00000653,Output Areas and Small Areas,OASA,254,66,188
283422,W00000655,W00000655,Output Areas and Small Areas,OASA,194,100,94
283423,W00000656,W00000656,Output Areas and Small Areas,OASA,266,112,154
283424,W00000657,W00000657,Output Areas and Small Areas,OASA,281,121,160
283425,W00000658,W00000658,Output Areas and Small Areas,OASA,262,94,168
283426,W00000659,W00000659,Output Areas and Small Areas,OASA,300,104,196
283427,W00000660,W00000660,Output Areas and Small Areas,OASA,297,106,191
283428,W00000661,W00000661,Output Areas and Small Areas,OASA,299,85,214
283429,W00000662,W00000662,Output Areas and Small Areas,OASA,238,59,179
283430,W00000663,W00000663,Output Areas and Small Areas,OASA,260,91,169
283431,W00000664,W00000664,Output Areas and Small Areas,OASA,229,74,155
283432,W00000665,W00000665,Output Areas and Small Areas,OASA,121,34,87
283433,W00000666,W00000666,Output Areas and Small Areas,OASA,193,73,120
283434,W00000667,W00000667,Output Areas and Small Areas,OASA,236,72,164
283435,W00000668,W00000668,Output Areas and Small Areas,OASA,399,93,306
283436,W00000669,W00000669,Output Areas and Small Areas,OASA,223,37,186
283437,W00000670,W00000670,Output Areas and Small Areas,OASA,244,39,205
283438,W00000671,W00000671,Output Areas and Small Areas,OASA,225,25,200
283439,W00000672,W00000672,Output Areas and Small Areas,OASA,245,34,211
283440,W00000673,W00000673,Output Areas and Small Areas,OASA,291,55,236
283441,W00000674,W00000674,Output Areas and Small Areas,OASA,315,59,256
283442,W00000675,W00000675,Output Areas and Small Areas,OASA,241,36,205
283443,W00000676,W00000676,Output Areas and Small Areas,OASA,279,63,216
283444,W00000677,W00000677,Output Areas and Small Areas,OASA,262,57,205
283445,W00000678,W00000678,Output Areas and Small Areas,OASA,247,53,194
283446,W00000679,W00000679,Output Areas and Small Areas,OASA,252,46,206
283447,W00000680,W00000680,Output Areas and Small Areas,OASA,279,38,241
283448,W00000681,W00000681,Output Areas and Small Areas,OASA,221,34,187
283449,W00000682,W00000682,Output Areas and Small Areas,OASA,173,29,144
283450,W00000683,W00000683,Output Areas and Small Areas,OASA,247,65,182
283451,W00000684,W00000684,Output Areas and Small Areas,OASA,241,57,184
283452,W00000685,W00000685,Output Areas and Small Areas,OASA,255,55,200
283453,W00000686,W00000686,Output Areas and Small Areas,OASA,217,66,151
283454,W00000687,W00000687,Output Areas and Small Areas,OASA,251,60,191
283455,W00000688,W00000688,Output Areas and Small Areas,OASA,269,73,196
283456,W00000689,W00000689,Output Areas and Small Areas,OASA,196,49,147
283457,W00000690,W00000690,Output Areas and Small Areas,OASA,203,57,146
283458,W00000691,W00000691,Output Areas and Small Areas,OASA,225,60,165
283459,W00000692,W00000692,Output Areas and Small Areas,OASA,196,53,143
283460,W00000693,W00000693,Output Areas and Small Areas,OASA,227,77,150
283461,W00000694,W00000694,Output Areas and Small Areas,OASA,263,72,191
283462,W00000695,W00000695,Output Areas and Small Areas,OASA,241,68,173
283463,W00000696,W00000696,Output Areas and Small Areas,OASA,200,47,153
283464,W00000697,W00000697,Output Areas and Small Areas,OASA,236,38,198
283465,W00000698,W00000698,Output Areas and Small Areas,OASA,260,39,221
283466,W00000699,W00000699,Output Areas and Small Areas,OASA,283,65,218
283467,W00000700,W00000700,Output Areas and Small Areas,OASA,299,58,241
283468,W00000701,W00000701,Output Areas and Small Areas,OASA,231,31,200
283469,W00000702,W00000702,Output Areas and Small Areas,OASA,277,56,221
283470,W00000703,W00000703,Output Areas and Small Areas,OASA,207,36,171
283471,W00000704,W00000704,Output Areas and Small Areas,OASA,167,26,141
283472,W00000705,W00000705,Output Areas and Small Areas,OASA,241,37,204
283473,W00000706,W00000706,Output Areas and Small Areas,OASA,181,28,153
283474,W00000707,W00000707,Output Areas and Small Areas,OASA,161,17,144
283475,W00000708,W00000708,Output Areas and Small Areas,OASA,262,46,216
283476,W00000709,W00000709,Output Areas and Small Areas,OASA,192,25,167
283477,W00000710,W00000710,Output Areas and Small Areas,OASA,246,144,102
283478,W00000711,W00000711,Output Areas and Small Areas,OASA,214,140,74
283479,W00000712,W00000712,Output Areas and Small Areas,OASA,258,155,103
283480,W00000713,W00000713,Output Areas and Small Areas,OASA,197,104,93
283481,W00000714,W00000714,Output Areas and Small Areas,OASA,244,112,132
283482,W00000715,W00000715,Output Areas and Small Areas,OASA,289,167,122
283483,W00000716,W00000716,Output Areas and Small Areas,OASA,299,162,137
283484,W00000717,W00000717,Output Areas and Small Areas,OASA,309,46,263
283485,W00000718,W00000718,Output Areas and Small Areas,OASA,176,31,145
283486,W00000719,W00000719,Output Areas and Small Areas,OASA,216,49,167
283487,W00000720,W00000720,Output Areas and Small Areas,OASA,286,61,225
283488,W00000721,W00000721,Output Areas and Small Areas,OASA,207,38,169
283489,W00000722,W00000722,Output Areas and Small Areas,OASA,234,37,197
283490,W00000723,W00000723,Output Areas and Small Areas,OASA,215,49,166
283491,W00000724,W00000724,Output Areas and Small Areas,OASA,201,29,172
283492,W00000725,W00000725,Output Areas and Small Areas,OASA,222,36,186
283493,W00000726,W00000726,Output Areas and Small Areas,OASA,267,65,202
283494,W00000727,W00000727,Output Areas and Small Areas,OASA,220,35,185
283495,W00000728,W00000728,Output Areas and Small Areas,OASA,256,52,204
283496,W00000729,W00000729,Output Areas and Small Areas,OASA,335,74,261
283497,W00000730,W00000730,Output Areas and Small Areas,OASA,262,61,201
283498,W00000731,W00000731,Output Areas and Small Areas,OASA,306,151,155
283499,W00000732,W00000732,Output Areas and Small Areas,OASA,244,123,121
283500,W00000733,W00000733,Output Areas and Small Areas,OASA,236,83,153
283501,W00000734,W00000734,Output Areas and Small Areas,OASA,226,121,105
283502,W00000735,W00000735,Output Areas and Small Areas,OASA,266,166,100
283503,W00000736,W00000736,Output Areas and Small Areas,OASA,226,58,168
283504,W00000737,W00000737,Output Areas and Small Areas,OASA,235,50,185
283505,W00000738,W00000738,Output Areas and Small Areas,OASA,263,64,199
283506,W00000739,W00000739,Output Areas and Small Areas,OASA,201,41,160
283507,W00000740,W00000740,Output Areas and Small Areas,OASA,238,39,199
283508,W00000741,W00000741,Output Areas and Small Areas,OASA,325,58,267
283509,W00000742,W00000742,Output Areas and Small Areas,OASA,175,28,147
283510,W00000743,W00000743,Output Areas and Small Areas,OASA,281,66,215
283511,W00000744,W00000744,Output Areas and Small Areas,OASA,187,36,151
283512,W00000745,W00000745,Output Areas and Small Areas,OASA,266,58,208
283513,W00000746,W00000746,Output Areas and Small Areas,OASA,224,45,179
283514,W00000747,W00000747,Output Areas and Small Areas,OASA,249,59,190
283515,W00000748,W00000748,Output Areas and Small Areas,OASA,421,77,344
283516,W00000749,W00000749,Output Areas and Small Areas,OASA,253,40,213
283517,W00000750,W00000750,Output Areas and Small Areas,OASA,136,18,118
283518,W00000752,W00000752,Output Areas and Small Areas,OASA,231,37,194
283519,W00000753,W00000753,Output Areas and Small Areas,OASA,213,57,156
283520,W00000754,W00000754,Output Areas and Small Areas,OASA,187,35,152
283521,W00000756,W00000756,Output Areas and Small Areas,OASA,176,29,147
283522,W00000757,W00000757,Output Areas and Small Areas,OASA,265,47,218
283523,W00000758,W00000758,Output Areas and Small Areas,OASA,234,54,180
283524,W00000759,W00000759,Output Areas and Small Areas,OASA,263,41,222
283525,W00000760,W00000760,Output Areas and Small Areas,OASA,204,50,154
283526,W00000761,W00000761,Output Areas and Small Areas,OASA,271,57,214
283527,W00000762,W00000762,Output Areas and Small Areas,OASA,190,51,139
283528,W00000763,W00000763,Output Areas and Small Areas,OASA,87,13,74
283529,W00000765,W00000765,Output Areas and Small Areas,OASA,262,21,241
283530,W00000766,W00000766,Output Areas and Small Areas,OASA,219,30,189
283531,W00000767,W00000767,Output Areas and Small Areas,OASA,200,27,173
283532,W00000768,W00000768,Output Areas and Small Areas,OASA,225,28,197
283533,W00000769,W00000769,Output Areas and Small Areas,OASA,297,50,247
283534,W00000770,W00000770,Output Areas and Small Areas,OASA,232,33,199
283535,W00000771,W00000771,Output Areas and Small Areas,OASA,372,99,273
283536,W00000772,W00000772,Output Areas and Small Areas,OASA,260,44,216
283537,W00000773,W00000773,Output Areas and Small Areas,OASA,227,43,184
283538,W00000774,W00000774,Output Areas and Small Areas,OASA,207,38,169
283539,W00000775,W00000775,Output Areas and Small Areas,OASA,221,42,179
283540,W00000776,W00000776,Output Areas and Small Areas,OASA,329,40,289
283541,W00000777,W00000777,Output Areas and Small Areas,OASA,165,16,149
283542,W00000778,W00000778,Output Areas and Small Areas,OASA,252,43,209
283543,W00000779,W00000779,Output Areas and Small Areas,OASA,217,39,178
283544,W00000780,W00000780,Output Areas and Small Areas,OASA,232,32,200
283545,W00000781,W00000781,Output Areas and Small Areas,OASA,212,32,180
283546,W00000782,W00000782,Output Areas and Small Areas,OASA,235,34,201
283547,W00000783,W00000783,Output Areas and Small Areas,OASA,263,36,227
283548,W00000784,W00000784,Output Areas and Small Areas,OASA,189,37,152
283549,W00000785,W00000785,Output Areas and Small Areas,OASA,223,29,194
283550,W00000786,W00000786,Output Areas and Small Areas,OASA,316,30,286
283551,W00000787,W00000787,Output Areas and Small Areas,OASA,247,35,212
283552,W00000788,W00000788,Output Areas and Small Areas,OASA,229,26,203
283553,W00000789,W00000789,Output Areas and Small Areas,OASA,304,38,266
283554,W00000790,W00000790,Output Areas and Small Areas,OASA,217,33,184
283555,W00000791,W00000791,Output Areas and Small Areas,OASA,243,37,206
283556,W00000792,W00000792,Output Areas and Small Areas,OASA,202,32,170
283557,W00000793,W00000793,Output Areas and Small Areas,OASA,243,152,91
283558,W00000794,W00000794,Output Areas and Small Areas,OASA,245,142,103
283559,W00000795,W00000795,Output Areas and Small Areas,OASA,223,134,89
283560,W00000796,W00000796,Output Areas and Small Areas,OASA,229,130,99
283561,W00000797,W00000797,Output Areas and Small Areas,OASA,252,29,223
283562,W00000798,W00000798,Output Areas and Small Areas,OASA,323,18,305
283563,W00000799,W00000799,Output Areas and Small Areas,OASA,237,23,214
283564,W00000800,W00000800,Output Areas and Small Areas,OASA,436,37,399
283565,W00000801,W00000801,Output Areas and Small Areas,OASA,226,22,204
283566,W00000802,W00000802,Output Areas and Small Areas,OASA,275,23,252
283567,W00000803,W00000803,Output Areas and Small Areas,OASA,241,25,216
283568,W00000804,W00000804,Output Areas and Small Areas,OASA,285,33,252
283569,W00000805,W00000805,Output Areas and Small Areas,OASA,236,22,214
283570,W00000806,W00000806,Output Areas and Small Areas,OASA,217,11,206
283571,W00000807,W00000807,Output Areas and Small Areas,OASA,226,12,214
283572,W00000808,W00000808,Output Areas and Small Areas,OASA,233,4,229
283573,W00000809,W00000809,Output Areas and Small Areas,OASA,284,12,272
283574,W00000810,W00000810,Output Areas and Small Areas,OASA,211,15,196
283575,W00000811,W00000811,Output Areas and Small Areas,OASA,239,8,231
283576,W00000812,W00000812,Output Areas and Small Areas,OASA,236,16,220
283577,W00000813,W00000813,Output Areas and Small Areas,OASA,246,17,229
283578,W00000814,W00000814,Output Areas and Small Areas,OASA,275,14,261
283579,W00000815,W00000815,Output Areas and Small Areas,OASA,230,12,218
283580,W00000816,W00000816,Output Areas and Small Areas,OASA,209,34,175
283581,W00000817,W00000817,Output Areas and Small Areas,OASA,218,29,189
283582,W00000818,W00000818,Output Areas and Small Areas,OASA,215,30,185
283583,W00000819,W00000819,Output Areas and Small Areas,OASA,235,44,191
283584,W00000820,W00000820,Output Areas and Small Areas,OASA,193,51,142
283585,W00000821,W00000821,Output Areas and Small Areas,OASA,242,54,188
283586,W00000822,W00000822,Output Areas and Small Areas,OASA,221,31,190
283587,W00000823,W00000823,Output Areas and Small Areas,OASA,239,34,205
283588,W00000824,W00000824,Output Areas and Small Areas,OASA,228,18,210
283589,W00000825,W00000825,Output Areas and Small Areas,OASA,375,56,319
283590,W00000826,W00000826,Output Areas and Small Areas,OASA,221,34,187
283591,W00000827,W00000827,Output Areas and Small Areas,OASA,236,39,197
283592,W00000828,W00000828,Output Areas and Small Areas,OASA,208,27,181
283593,W00000829,W00000829,Output Areas and Small Areas,OASA,264,54,210
283594,W00000830,W00000830,Output Areas and Small Areas,OASA,242,34,208
283595,W00000831,W00000831,Output Areas and Small Areas,OASA,177,29,148
283596,W00000832,W00000832,Output Areas and Small Areas,OASA,221,54,167
283597,W00000833,W00000833,Output Areas and Small Areas,OASA,213,22,191
283598,W00000834,W00000834,Output Areas and Small Areas,OASA,237,52,185
283599,W00000835,W00000835,Output Areas and Small Areas,OASA,213,22,191
283600,W00000836,W00000836,Output Areas and Small Areas,OASA,184,20,164
283601,W00000837,W00000837,Output Areas and Small Areas,OASA,228,31,197
283602,W00000838,W00000838,Output Areas and Small Areas,OASA,256,30,226
283603,W00000839,W00000839,Output Areas and Small Areas,OASA,218,41,177
283604,W00000840,W00000840,Output Areas and Small Areas,OASA,258,44,214
283605,W00000841,W00000841,Output Areas and Small Areas,OASA,281,40,241
283606,W00000842,W00000842,Output Areas and Small Areas,OASA,343,73,270
283607,W00000843,W00000843,Output Areas and Small Areas,OASA,217,32,185
283608,W00000844,W00000844,Output Areas and Small Areas,OASA,282,55,227
283609,W00000845,W00000845,Output Areas and Small Areas,OASA,234,31,203
283610,W00000846,W00000846,Output Areas and Small Areas,OASA,355,69,286
283611,W00000847,W00000847,Output Areas and Small Areas,OASA,235,44,191
283612,W00000848,W00000848,Output Areas and Small Areas,OASA,216,26,190
283613,W00000849,W00000849,Output Areas and Small Areas,OASA,282,167,115
283614,W00000850,W00000850,Output Areas and Small Areas,OASA,293,161,132
283615,W00000851,W00000851,Output Areas and Small Areas,OASA,317,217,100
283616,W00000852,W00000852,Output Areas and Small Areas,OASA,303,204,99
283617,W00000853,W00000853,Output Areas and Small Areas,OASA,184,44,140
283618,W00000854,W00000854,Output Areas and Small Areas,OASA,391,128,263
283619,W00000855,W00000855,Output Areas and Small Areas,OASA,210,60,150
283620,W00000856,W00000856,Output Areas and Small Areas,OASA,224,64,160
283621,W00000857,W00000857,Output Areas and Small Areas,OASA,217,67,150
283622,W00000858,W00000858,Output Areas and Small Areas,OASA,212,79,133
283623,W00000859,W00000859,Output Areas and Small Areas,OASA,204,75,129
283624,W00000860,W00000860,Output Areas and Small Areas,OASA,230,80,150
283625,W00000861,W00000861,Output Areas and Small Areas,OASA,249,130,119
283626,W00000862,W00000862,Output Areas and Small Areas,OASA,206,128,78
283627,W00000863,W00000863,Output Areas and Small Areas,OASA,290,158,132
283628,W00000864,W00000864,Output Areas and Small Areas,OASA,260,152,108
283629,W00000865,W00000865,Output Areas and Small Areas,OASA,267,140,127
283630,W00000866,W00000866,Output Areas and Small Areas,OASA,283,210,73
283631,W00000867,W00000867,Output Areas and Small Areas,OASA,305,50,255
283632,W00000868,W00000868,Output Areas and Small Areas,OASA,227,42,185
283633,W00000869,W00000869,Output Areas and Small Areas,OASA,262,43,219
283634,W00000870,W00000870,Output Areas and Small Areas,OASA,262,58,204
283635,W00000871,W00000871,Output Areas and Small Areas,OASA,231,49,182
283636,W00000872,W00000872,Output Areas and Small Areas,OASA,261,39,222
283637,W00000873,W00000873,Output Areas and Small Areas,OASA,247,25,222
283638,W00000874,W00000874,Output Areas and Small Areas,OASA,254,48,206
283639,W00000875,W00000875,Output Areas and Small Areas,OASA,194,49,145
283640,W00000876,W00000876,Output Areas and Small Areas,OASA,208,47,161
283641,W00000877,W00000877,Output Areas and Small Areas,OASA,231,65,166
283642,W00000878,W00000878,Output Areas and Small Areas,OASA,258,68,190
283643,W00000879,W00000879,Output Areas and Small Areas,OASA,429,113,316
283644,W00000880,W00000880,Output Areas and Small Areas,OASA,265,74,191
283645,W00000881,W00000881,Output Areas and Small Areas,OASA,224,48,176
283646,W00000882,W00000882,Output Areas and Small Areas,OASA,207,58,149
283647,W00000883,W00000883,Output Areas and Small Areas,OASA,239,64,175
283648,W00000884,W00000884,Output Areas and Small Areas,OASA,231,56,175
283649,W00000885,W00000885,Output Areas and Small Areas,OASA,224,58,166
283650,W00000886,W00000886,Output Areas and Small Areas,OASA,236,75,161
283651,W00000887,W00000887,Output Areas and Small Areas,OASA,254,69,185
283652,W00000888,W00000888,Output Areas and Small Areas,OASA,240,63,177
283653,W00000889,W00000889,Output Areas and Small Areas,OASA,232,41,191
283654,W00000890,W00000890,Output Areas and Small Areas,OASA,303,71,232
283655,W00000891,W00000891,Output Areas and Small Areas,OASA,256,65,191
283656,W00000892,W00000892,Output Areas and Small Areas,OASA,228,44,184
283657,W00000893,W00000893,Output Areas and Small Areas,OASA,267,40,227
283658,W00000894,W00000894,Output Areas and Small Areas,OASA,243,27,216
283659,W00000895,W00000895,Output Areas and Small Areas,OASA,212,27,185
283660,W00000896,W00000896,Output Areas and Small Areas,OASA,280,34,246
283661,W00000897,W00000897,Output Areas and Small Areas,OASA,238,40,198
283662,W00000898,W00000898,Output Areas and Small Areas,OASA,283,49,234
283663,W00000899,W00000899,Output Areas and Small Areas,OASA,197,33,164
283664,W00000900,W00000900,Output Areas and Small Areas,OASA,192,28,164
283665,W00000901,W00000901,Output Areas and Small Areas,OASA,196,28,168
283666,W00000902,W00000902,Output Areas and Small Areas,OASA,257,39,218
283667,W00000903,W00000903,Output Areas and Small Areas,OASA,271,55,216
283668,W00000904,W00000904,Output Areas and Small Areas,OASA,234,42,192
283669,W00000905,W00000905,Output Areas and Small Areas,OASA,243,41,202
283670,W00000906,W00000906,Output Areas and Small Areas,OASA,219,30,189
283671,W00000907,W00000907,Output Areas and Small Areas,OASA,289,151,138
283672,W00000908,W00000908,Output Areas and Small Areas,OASA,252,114,138
283673,W00000909,W00000909,Output Areas and Small Areas,OASA,245,136,109
283674,W00000910,W00000910,Output Areas and Small Areas,OASA,252,121,131
283675,W00000911,W00000911,Output Areas and Small Areas,OASA,246,93,153
283676,W00000912,W00000912,Output Areas and Small Areas,OASA,238,103,135
283677,W00000913,W00000913,Output Areas and Small Areas,OASA,308,100,208
283678,W00000914,W00000914,Output Areas and Small Areas,OASA,277,93,184
283679,W00000915,W00000915,Output Areas and Small Areas,OASA,282,88,194
283680,W00000916,W00000916,Output Areas and Small Areas,OASA,345,63,282
283681,W00000917,W00000917,Output Areas and Small Areas,OASA,247,80,167
283682,W00000918,W00000918,Output Areas and Small Areas,OASA,412,145,267
283683,W00000919,W00000919,Output Areas and Small Areas,OASA,228,87,141
283684,W00000920,W00000920,Output Areas and Small Areas,OASA,262,57,205
283685,W00000921,W00000921,Output Areas and Small Areas,OASA,239,43,196
283686,W00000922,W00000922,Output Areas and Small Areas,OASA,231,42,189
283687,W00000923,W00000923,Output Areas and Small Areas,OASA,193,39,154
283688,W00000924,W00000924,Output Areas and Small Areas,OASA,216,28,188
283689,W00000925,W00000925,Output Areas and Small Areas,OASA,252,42,210
283690,W00000926,W00000926,Output Areas and Small Areas,OASA,272,57,215
283691,W00000927,W00000927,Output Areas and Small Areas,OASA,263,54,209
283692,W00000928,W00000928,Output Areas and Small Areas,OASA,222,45,177
283693,W00000929,W00000929,Output Areas and Small Areas,OASA,233,44,189
283694,W00000930,W00000930,Output Areas and Small Areas,OASA,243,50,193
283695,W00000931,W00000931,Output Areas and Small Areas,OASA,218,47,171
283696,W00000932,W00000932,Output Areas and Small Areas,OASA,328,70,258
283697,W00000933,W00000933,Output Areas and Small Areas,OASA,212,40,172
283698,W00000934,W00000934,Output Areas and Small Areas,OASA,261,70,191
283699,W00000935,W00000935,Output Areas and Small Areas,OASA,231,54,177
283700,W00000936,W00000936,Output Areas and Small Areas,OASA,241,37,204
283701,W00000937,W00000937,Output Areas and Small Areas,OASA,217,15,202
283702,W00000938,W00000938,Output Areas and Small Areas,OASA,264,63,201
283703,W00000939,W00000939,Output Areas and Small Areas,OASA,267,75,192
283704,W00000940,W00000940,Output Areas and Small Areas,OASA,282,73,209
283705,W00000941,W00000941,Output Areas and Small Areas,OASA,241,68,173
283706,W00000942,W00000942,Output Areas and Small Areas,OASA,273,74,199
283707,W00000943,W00000943,Output Areas and Small Areas,OASA,265,59,206
283708,W00000944,W00000944,Output Areas and Small Areas,OASA,237,58,179
283709,W00000945,W00000945,Output Areas and Small Areas,OASA,251,54,197
283710,W00000946,W00000946,Output Areas and Small Areas,OASA,224,64,160
283711,W00000947,W00000947,Output Areas and Small Areas,OASA,277,46,231
283712,W00000948,W00000948,Output Areas and Small Areas,OASA,273,77,196
283713,W00000949,W00000949,Output Areas and Small Areas,OASA,258,57,201
283714,W00000950,W00000950,Output Areas and Small Areas,OASA,222,43,179
283715,W00000951,W00000951,Output Areas and Small Areas,OASA,239,43,196
283716,W00000952,W00000952,Output Areas and Small Areas,OASA,226,38,188
283717,W00000953,W00000953,Output Areas and Small Areas,OASA,353,49,304
283718,W00000954,W00000954,Output Areas and Small Areas,OASA,199,45,154
283719,W00000955,W00000955,Output Areas and Small Areas,OASA,259,60,199
283720,W00000956,W00000956,Output Areas and Small Areas,OASA,194,28,166
283721,W00000957,W00000957,Output Areas and Small Areas,OASA,249,33,216
283722,W00000958,W00000958,Output Areas and Small Areas,OASA,197,26,171
283723,W00000959,W00000959,Output Areas and Small Areas,OASA,262,56,206
283724,W00000960,W00000960,Output Areas and Small Areas,OASA,296,26,270
283725,W00000961,W00000961,Output Areas and Small Areas,OASA,490,64,426
283726,W00000962,W00000962,Output Areas and Small Areas,OASA,269,41,228
283727,W00000963,W00000963,Output Areas and Small Areas,OASA,307,45,262
283728,W00000964,W00000964,Output Areas and Small Areas,OASA,294,52,242
283729,W00000965,W00000965,Output Areas and Small Areas,OASA,443,44,399
283730,W00000966,W00000966,Output Areas and Small Areas,OASA,231,31,200
283731,W00000967,W00000967,Output Areas and Small Areas,OASA,242,34,208
283732,W00000968,W00000968,Output Areas and Small Areas,OASA,166,18,148
283733,W00000969,W00000969,Output Areas and Small Areas,OASA,263,33,230
283734,W00000970,W00000970,Output Areas and Small Areas,OASA,189,29,160
283735,W00000971,W00000971,Output Areas and Small Areas,OASA,383,44,339
283736,W00000972,W00000972,Output Areas and Small Areas,OASA,301,42,259
283737,W00000973,W00000973,Output Areas and Small Areas,OASA,246,54,192
283738,W00000974,W00000974,Output Areas and Small Areas,OASA,385,56,329
283739,W00000975,W00000975,Output Areas and Small Areas,OASA,244,48,196
283740,W00000976,W00000976,Output Areas and Small Areas,OASA,289,45,244
283741,W00000977,W00000977,Output Areas and Small Areas,OASA,196,33,163
283742,W00000978,W00000978,Output Areas and Small Areas,OASA,354,27,327
283743,W00000979,W00000979,Output Areas and Small Areas,OASA,275,18,257
283744,W00000980,W00000980,Output Areas and Small Areas,OASA,122,10,112
283745,W00000981,W00000981,Output Areas and Small Areas,OASA,390,34,356
283746,W00000982,W00000982,Output Areas and Small Areas,OASA,210,23,187
283747,W00000983,W00000983,Output Areas and Small Areas,OASA,233,7,226
283748,W00000984,W00000984,Output Areas and Small Areas,OASA,236,22,214
283749,W00000985,W00000985,Output Areas and Small Areas,OASA,236,20,216
283750,W00000986,W00000986,Output Areas and Small Areas,OASA,357,152,205
283751,W00000987,W00000987,Output Areas and Small Areas,OASA,149,54,95
283752,W00000988,W00000988,Output Areas and Small Areas,OASA,258,96,162
283753,W00000989,W00000989,Output Areas and Small Areas,OASA,277,126,151
283754,W00000990,W00000990,Output Areas and Small Areas,OASA,166,25,141
283755,W00000991,W00000991,Output Areas and Small Areas,OASA,211,43,168
283756,W00000992,W00000992,Output Areas and Small Areas,OASA,200,39,161
283757,W00000993,W00000993,Output Areas and Small Areas,OASA,210,35,175
283758,W00000994,W00000994,Output Areas and Small Areas,OASA,225,42,183
283759,W00000995,W00000995,Output Areas and Small Areas,OASA,237,46,191
283760,W00000996,W00000996,Output Areas and Small Areas,OASA,228,63,165
283761,W00000997,W00000997,Output Areas and Small Areas,OASA,218,38,180
283762,W00000998,W00000998,Output Areas and Small Areas,OASA,229,40,189
283763,W00000999,W00000999,Output Areas and Small Areas,OASA,242,51,191
283764,W00001000,W00001000,Output Areas and Small Areas,OASA,256,64,192
283765,W00001001,W00001001,Output Areas and Small Areas,OASA,256,47,209
283766,W00001002,W00001002,Output Areas and Small Areas,OASA,297,62,235
283767,W00001003,W00001003,Output Areas and Small Areas,OASA,248,44,204
283768,W00001004,W00001004,Output Areas and Small Areas,OASA,361,46,315
283769,W00001005,W00001005,Output Areas and Small Areas,OASA,201,32,169
283770,W00001006,W00001006,Output Areas and Small Areas,OASA,225,43,182
283771,W00001007,W00001007,Output Areas and Small Areas,OASA,280,150,130
283772,W00001008,W00001008,Output Areas and Small Areas,OASA,281,166,115
283773,W00001009,W00001009,Output Areas and Small Areas,OASA,226,118,108
283774,W00001010,W00001010,Output Areas and Small Areas,OASA,310,173,137
283775,W00001011,W00001011,Output Areas and Small Areas,OASA,157,119,38
283776,W00001012,W00001012,Output Areas and Small Areas,OASA,373,262,111
283777,W00001013,W00001013,Output Areas and Small Areas,OASA,245,202,43
283778,W00001014,W00001014,Output Areas and Small Areas,OASA,157,102,55
283779,W00001015,W00001015,Output Areas and Small Areas,OASA,221,146,75
283780,W00001016,W00001016,Output Areas and Small Areas,OASA,178,82,96
283781,W00001017,W00001017,Output Areas and Small Areas,OASA,190,34,156
283782,W00001018,W00001018,Output Areas and Small Areas,OASA,228,45,183
283783,W00001019,W00001019,Output Areas and Small Areas,OASA,179,49,130
283784,W00001020,W00001020,Output Areas and Small Areas,OASA,221,17,204
283785,W00001021,W00001021,Output Areas and Small Areas,OASA,181,28,153
283786,W00001022,W00001022,Output Areas and Small Areas,OASA,192,32,160
283787,W00001023,W00001023,Output Areas and Small Areas,OASA,111,15,96
283788,W00001024,W00001024,Output Areas and Small Areas,OASA,228,21,207
283789,W00001025,W00001025,Output Areas and Small Areas,OASA,183,24,159
283790,W00001026,W00001026,Output Areas and Small Areas,OASA,197,110,87
283791,W00001027,W00001027,Output Areas and Small Areas,OASA,218,87,131
283792,W00001028,W00001028,Output Areas and Small Areas,OASA,270,102,168
283793,W00001029,W00001029,Output Areas and Small Areas,OASA,204,79,125
283794,W00001030,W00001030,Output Areas and Small Areas,OASA,185,103,82
283795,W00001031,W00001031,Output Areas and Small Areas,OASA,263,134,129
283796,W00001032,W00001032,Output Areas and Small Areas,OASA,273,142,131
283797,W00001033,W00001033,Output Areas and Small Areas,OASA,342,142,200
283798,W00001034,W00001034,Output Areas and Small Areas,OASA,209,58,151
283799,W00001035,W00001035,Output Areas and Small Areas,OASA,224,69,155
283800,W00001036,W00001036,Output Areas and Small Areas,OASA,233,92,141
283801,W00001037,W00001037,Output Areas and Small Areas,OASA,206,66,140
283802,W00001038,W00001038,Output Areas and Small Areas,OASA,306,97,209
283803,W00001039,W00001039,Output Areas and Small Areas,OASA,321,76,245
283804,W00001040,W00001040,Output Areas and Small Areas,OASA,262,67,195
283805,W00001041,W00001041,Output Areas and Small Areas,OASA,281,121,160
283806,W00001042,W00001042,Output Areas and Small Areas,OASA,240,74,166
283807,W00001043,W00001043,Output Areas and Small Areas,OASA,292,108,184
283808,W00001044,W00001044,Output Areas and Small Areas,OASA,299,115,184
283809,W00001045,W00001045,Output Areas and Small Areas,OASA,237,67,170
283810,W00001046,W00001046,Output Areas and Small Areas,OASA,326,105,221
283811,W00001047,W00001047,Output Areas and Small Areas,OASA,243,107,136
283812,W00001048,W00001048,Output Areas and Small Areas,OASA,305,117,188
283813,W00001049,W00001049,Output Areas and Small Areas,OASA,264,91,173
283814,W00001050,W00001050,Output Areas and Small Areas,OASA,310,134,176
283815,W00001051,W00001051,Output Areas and Small Areas,OASA,254,126,128
283816,W00001052,W00001052,Output Areas and Small Areas,OASA,230,110,120
283817,W00001053,W00001053,Output Areas and Small Areas,OASA,212,93,119
283818,W00001054,W00001054,Output Areas and Small Areas,OASA,231,83,148
283819,W00001055,W00001055,Output Areas and Small Areas,OASA,226,60,166
283820,W00001056,W00001056,Output Areas and Small Areas,OASA,208,52,156
283821,W00001057,W00001057,Output Areas and Small Areas,OASA,234,52,182
283822,W00001058,W00001058,Output Areas and Small Areas,OASA,273,75,198
283823,W00001059,W00001059,Output Areas and Small Areas,OASA,241,60,181
283824,W00001060,W00001060,Output Areas and Small Areas,OASA,166,76,90
283825,W00001061,W00001061,Output Areas and Small Areas,OASA,240,56,184
283826,W00001062,W00001062,Output Areas and Small Areas,OASA,213,61,152
283827,W00001063,W00001063,Output Areas and Small Areas,OASA,217,73,144
283828,W00001064,W00001064,Output Areas and Small Areas,OASA,272,122,150
283829,W00001065,W00001065,Output Areas and Small Areas,OASA,233,78,155
283830,W00001066,W00001066,Output Areas and Small Areas,OASA,238,36,202
283831,W00001067,W00001067,Output Areas and Small Areas,OASA,235,36,199
283832,W00001068,W00001068,Output Areas and Small Areas,OASA,269,43,226
283833,W00001069,W00001069,Output Areas and Small Areas,OASA,184,18,166
283834,W00001070,W00001070,Output Areas and Small Areas,OASA,242,42,200
283835,W00001071,W00001071,Output Areas and Small Areas,OASA,260,57,203
283836,W00001072,W00001072,Output Areas and Small Areas,OASA,269,54,215
283837,W00001074,W00001074,Output Areas and Small Areas,OASA,270,141,129
283838,W00001075,W00001075,Output Areas and Small Areas,OASA,198,96,102
283839,W00001076,W00001076,Output Areas and Small Areas,OASA,351,145,206
283840,W00001077,W00001077,Output Areas and Small Areas,OASA,269,146,123
283841,W00001078,W00001078,Output Areas and Small Areas,OASA,238,112,126
283842,W00001079,W00001079,Output Areas and Small Areas,OASA,275,50,225
283843,W00001080,W00001080,Output Areas and Small Areas,OASA,319,69,250
283844,W00001081,W00001081,Output Areas and Small Areas,OASA,197,38,159
283845,W00001082,W00001082,Output Areas and Small Areas,OASA,95,32,63
283846,W00001083,W00001083,Output Areas and Small Areas,OASA,236,53,183
283847,W00001084,W00001084,Output Areas and Small Areas,OASA,219,57,162
283848,W00001085,W00001085,Output Areas and Small Areas,OASA,376,57,319
283849,W00001086,W00001086,Output Areas and Small Areas,OASA,326,60,266
283850,W00001087,W00001087,Output Areas and Small Areas,OASA,260,67,193
283851,W00001088,W00001088,Output Areas and Small Areas,OASA,257,76,181
283852,W00001089,W00001089,Output Areas and Small Areas,OASA,179,42,137
283853,W00001090,W00001090,Output Areas and Small Areas,OASA,242,82,160
283854,W00001091,W00001091,Output Areas and Small Areas,OASA,298,102,196
283855,W00001092,W00001092,Output Areas and Small Areas,OASA,221,142,79
283856,W00001093,W00001093,Output Areas and Small Areas,OASA,238,111,127
283857,W00001094,W00001094,Output Areas and Small Areas,OASA,254,167,87
283858,W00001095,W00001095,Output Areas and Small Areas,OASA,236,108,128
283859,W00001096,W00001096,Output Areas and Small Areas,OASA,274,71,203
283860,W00001097,W00001097,Output Areas and Small Areas,OASA,273,86,187
283861,W00001098,W00001098,Output Areas and Small Areas,OASA,333,85,248
283862,W00001099,W00001099,Output Areas and Small Areas,OASA,280,89,191
283863,W00001100,W00001100,Output Areas and Small Areas,OASA,334,141,193
283864,W00001101,W00001101,Output Areas and Small Areas,OASA,258,115,143
283865,W00001102,W00001102,Output Areas and Small Areas,OASA,314,99,215
283866,W00001103,W00001103,Output Areas and Small Areas,OASA,190,118,72
283867,W00001104,W00001104,Output Areas and Small Areas,OASA,229,127,102
283868,W00001105,W00001105,Output Areas and Small Areas,OASA,253,103,150
283869,W00001106,W00001106,Output Areas and Small Areas,OASA,320,116,204
283870,W00001107,W00001107,Output Areas and Small Areas,OASA,261,115,146
283871,W00001108,W00001108,Output Areas and Small Areas,OASA,312,153,159
283872,W00001109,W00001109,Output Areas and Small Areas,OASA,260,47,213
283873,W00001110,W00001110,Output Areas and Small Areas,OASA,237,45,192
283874,W00001111,W00001111,Output Areas and Small Areas,OASA,302,47,255
283875,W00001112,W00001112,Output Areas and Small Areas,OASA,269,45,224
283876,W00001113,W00001113,Output Areas and Small Areas,OASA,223,26,197
283877,W00001114,W00001114,Output Areas and Small Areas,OASA,206,32,174
283878,W00001115,W00001115,Output Areas and Small Areas,OASA,254,41,213
283879,W00001116,W00001116,Output Areas and Small Areas,OASA,173,37,136
283880,W00001117,W00001117,Output Areas and Small Areas,OASA,211,32,179
283881,W00001118,W00001118,Output Areas and Small Areas,OASA,240,30,210
283882,W00001119,W00001119,Output Areas and Small Areas,OASA,313,51,262
283883,W00001120,W00001120,Output Areas and Small Areas,OASA,262,40,222
283884,W00001121,W00001121,Output Areas and Small Areas,OASA,190,29,161
283885,W00001122,W00001122,Output Areas and Small Areas,OASA,362,80,282
283886,W00001123,W00001123,Output Areas and Small Areas,OASA,410,203,207
283887,W00001124,W00001124,Output Areas and Small Areas,OASA,250,134,116
283888,W00001125,W00001125,Output Areas and Small Areas,OASA,184,86,98
283889,W00001126,W00001126,Output Areas and Small Areas,OASA,237,112,125
283890,W00001127,W00001127,Output Areas and Small Areas,OASA,179,85,94
283891,W00001128,W00001128,Output Areas and Small Areas,OASA,281,110,171
283892,W00001129,W00001129,Output Areas and Small Areas,OASA,249,42,207
283893,W00001130,W00001130,Output Areas and Small Areas,OASA,252,36,216
283894,W00001131,W00001131,Output Areas and Small Areas,OASA,241,40,201
283895,W00001132,W00001132,Output Areas and Small Areas,OASA,260,41,219
283896,W00001133,W00001133,Output Areas and Small Areas,OASA,331,47,284
283897,W00001134,W00001134,Output Areas and Small Areas,OASA,205,18,187
283898,W00001135,W00001135,Output Areas and Small Areas,OASA,175,14,161
283899,W00001136,W00001136,Output Areas and Small Areas,OASA,217,24,193
283900,W00001137,W00001137,Output Areas and Small Areas,OASA,198,11,187
283901,W00001138,W00001138,Output Areas and Small Areas,OASA,248,20,228
283902,W00001139,W00001139,Output Areas and Small Areas,OASA,265,42,223
283903,W00001140,W00001140,Output Areas and Small Areas,OASA,239,24,215
283904,W00001141,W00001141,Output Areas and Small Areas,OASA,241,31,210
283905,W00001142,W00001142,Output Areas and Small Areas,OASA,222,38,184
283906,W00001143,W00001143,Output Areas and Small Areas,OASA,238,25,213
283907,W00001144,W00001144,Output Areas and Small Areas,OASA,233,37,196
283908,W00001145,W00001145,Output Areas and Small Areas,OASA,197,23,174
283909,W00001146,W00001146,Output Areas and Small Areas,OASA,190,20,170
283910,W00001147,W00001147,Output Areas and Small Areas,OASA,249,33,216
283911,W00001148,W00001148,Output Areas and Small Areas,OASA,281,32,249
283912,W00001149,W00001149,Output Areas and Small Areas,OASA,216,27,189
283913,W00001150,W00001150,Output Areas and Small Areas,OASA,236,35,201
283914,W00001151,W00001151,Output Areas and Small Areas,OASA,243,25,218
283915,W00001152,W00001152,Output Areas and Small Areas,OASA,254,19,235
283916,W00001153,W00001153,Output Areas and Small Areas,OASA,174,21,153
283917,W00001154,W00001154,Output Areas and Small Areas,OASA,267,28,239
283918,W00001155,W00001155,Output Areas and Small Areas,OASA,231,21,210
283919,W00001156,W00001156,Output Areas and Small Areas,OASA,258,40,218
283920,W00001157,W00001157,Output Areas and Small Areas,OASA,223,28,195
283921,W00001158,W00001158,Output Areas and Small Areas,OASA,187,24,163
283922,W00001159,W00001159,Output Areas and Small Areas,OASA,243,35,208
283923,W00001160,W00001160,Output Areas and Small Areas,OASA,243,38,205
283924,W00001161,W00001161,Output Areas and Small Areas,OASA,245,42,203
283925,W00001162,W00001162,Output Areas and Small Areas,OASA,223,13,210
283926,W00001163,W00001163,Output Areas and Small Areas,OASA,207,14,193
283927,W00001164,W00001164,Output Areas and Small Areas,OASA,189,17,172
283928,W00001166,W00001166,Output Areas and Small Areas,OASA,224,28,196
283929,W00001167,W00001167,Output Areas and Small Areas,OASA,210,14,196
283930,W00001168,W00001168,Output Areas and Small Areas,OASA,209,5,204
283931,W00001169,W00001169,Output Areas and Small Areas,OASA,246,22,224
283932,W00001170,W00001170,Output Areas and Small Areas,OASA,208,18,190
283933,W00001171,W00001171,Output Areas and Small Areas,OASA,209,16,193
283934,W00001172,W00001172,Output Areas and Small Areas,OASA,204,9,195
283935,W00001173,W00001173,Output Areas and Small Areas,OASA,359,33,326
283936,W00001174,W00001174,Output Areas and Small Areas,OASA,241,20,221
283937,W00001175,W00001175,Output Areas and Small Areas,OASA,194,12,182
283938,W00001176,W00001176,Output Areas and Small Areas,OASA,282,28,254
283939,W00001177,W00001177,Output Areas and Small Areas,OASA,229,20,209
283940,W00001178,W00001178,Output Areas and Small Areas,OASA,181,13,168
283941,W00001179,W00001179,Output Areas and Small Areas,OASA,159,14,145
283942,W00001180,W00001180,Output Areas and Small Areas,OASA,200,13,187
283943,W00001181,W00001181,Output Areas and Small Areas,OASA,232,26,206
283944,W00001182,W00001182,Output Areas and Small Areas,OASA,231,33,198
283945,W00001183,W00001183,Output Areas and Small Areas,OASA,182,20,162
283946,W00001184,W00001184,Output Areas and Small Areas,OASA,152,13,139
283947,W00001185,W00001185,Output Areas and Small Areas,OASA,184,23,161
283948,W00001186,W00001186,Output Areas and Small Areas,OASA,204,20,184
283949,W00001187,W00001187,Output Areas and Small Areas,OASA,186,13,173
283950,W00001188,W00001188,Output Areas and Small Areas,OASA,184,12,172
283951,W00001189,W00001189,Output Areas and Small Areas,OASA,169,17,152
283952,W00001190,W00001190,Output Areas and Small Areas,OASA,209,17,192
283953,W00001191,W00001191,Output Areas and Small Areas,OASA,249,32,217
283954,W00001192,W00001192,Output Areas and Small Areas,OASA,197,21,176
283955,W00001193,W00001193,Output Areas and Small Areas,OASA,194,14,180
283956,W00001194,W00001194,Output Areas and Small Areas,OASA,240,33,207
283957,W00001195,W00001195,Output Areas and Small Areas,OASA,228,47,181
283958,W00001196,W00001196,Output Areas and Small Areas,OASA,211,39,172
283959,W00001197,W00001197,Output Areas and Small Areas,OASA,170,30,140
283960,W00001198,W00001198,Output Areas and Small Areas,OASA,285,55,230
283961,W00001199,W00001199,Output Areas and Small Areas,OASA,225,42,183
283962,W00001200,W00001200,Output Areas and Small Areas,OASA,171,26,145
283963,W00001201,W00001201,Output Areas and Small Areas,OASA,192,40,152
283964,W00001202,W00001202,Output Areas and Small Areas,OASA,288,47,241
283965,W00001203,W00001203,Output Areas and Small Areas,OASA,414,57,357
283966,W00001204,W00001204,Output Areas and Small Areas,OASA,246,48,198
283967,W00001205,W00001205,Output Areas and Small Areas,OASA,207,33,174
283968,W00001206,W00001206,Output Areas and Small Areas,OASA,226,45,181
283969,W00001207,W00001207,Output Areas and Small Areas,OASA,227,31,196
283970,W00001208,W00001208,Output Areas and Small Areas,OASA,212,26,186
283971,W00001209,W00001209,Output Areas and Small Areas,OASA,188,22,166
283972,W00001210,W00001210,Output Areas and Small Areas,OASA,190,19,171
283973,W00001211,W00001211,Output Areas and Small Areas,OASA,153,10,143
283974,W00001212,W00001212,Output Areas and Small Areas,OASA,284,25,259
283975,W00001213,W00001213,Output Areas and Small Areas,OASA,253,30,223
283976,W00001214,W00001214,Output Areas and Small Areas,OASA,269,28,241
283977,W00001215,W00001215,Output Areas and Small Areas,OASA,208,22,186
283978,W00001216,W00001216,Output Areas and Small Areas,OASA,216,21,195
283979,W00001217,W00001217,Output Areas and Small Areas,OASA,232,11,221
283980,W00001218,W00001218,Output Areas and Small Areas,OASA,202,11,191
283981,W00001219,W00001219,Output Areas and Small Areas,OASA,205,11,194
283982,W00001220,W00001220,Output Areas and Small Areas,OASA,277,25,252
283983,W00001221,W00001221,Output Areas and Small Areas,OASA,215,24,191
283984,W00001222,W00001222,Output Areas and Small Areas,OASA,212,22,190
283985,W00001223,W00001223,Output Areas and Small Areas,OASA,238,21,217
283986,W00001224,W00001224,Output Areas and Small Areas,OASA,229,31,198
283987,W00001225,W00001225,Output Areas and Small Areas,OASA,216,29,187
283988,W00001226,W00001226,Output Areas and Small Areas,OASA,234,22,212
283989,W00001227,W00001227,Output Areas and Small Areas,OASA,228,29,199
283990,W00001228,W00001228,Output Areas and Small Areas,OASA,229,25,204
283991,W00001229,W00001229,Output Areas and Small Areas,OASA,252,32,220
283992,W00001230,W00001230,Output Areas and Small Areas,OASA,236,34,202
283993,W00001231,W00001231,Output Areas and Small Areas,OASA,268,44,224
283994,W00001232,W00001232,Output Areas and Small Areas,OASA,241,29,212
283995,W00001233,W00001233,Output Areas and Small Areas,OASA,208,20,188
283996,W00001234,W00001234,Output Areas and Small Areas,OASA,228,20,208
283997,W00001235,W00001235,Output Areas and Small Areas,OASA,240,31,209
283998,W00001236,W00001236,Output Areas and Small Areas,OASA,272,51,221
283999,W00001237,W00001237,Output Areas and Small Areas,OASA,208,12,196
284000,W00001238,W00001238,Output Areas and Small Areas,OASA,314,53,261
284001,W00001239,W00001239,Output Areas and Small Areas,OASA,280,37,243
284002,W00001240,W00001240,Output Areas and Small Areas,OASA,228,28,200
284003,W00001241,W00001241,Output Areas and Small Areas,OASA,178,19,159
284004,W00001242,W00001242,Output Areas and Small Areas,OASA,200,18,182
284005,W00001243,W00001243,Output Areas and Small Areas,OASA,222,25,197
284006,W00001244,W00001244,Output Areas and Small Areas,OASA,250,24,226
284007,W00001245,W00001245,Output Areas and Small Areas,OASA,219,28,191
284008,W00001246,W00001246,Output Areas and Small Areas,OASA,253,34,219
284009,W00001247,W00001247,Output Areas and Small Areas,OASA,230,15,215
284010,W00001248,W00001248,Output Areas and Small Areas,OASA,194,21,173
284011,W00001249,W00001249,Output Areas and Small Areas,OASA,286,30,256
284012,W00001250,W00001250,Output Areas and Small Areas,OASA,253,32,221
284013,W00001251,W00001251,Output Areas and Small Areas,OASA,201,19,182
284014,W00001252,W00001252,Output Areas and Small Areas,OASA,223,27,196
284015,W00001253,W00001253,Output Areas and Small Areas,OASA,360,49,311
284016,W00001254,W00001254,Output Areas and Small Areas,OASA,170,15,155
284017,W00001255,W00001255,Output Areas and Small Areas,OASA,259,42,217
284018,W00001256,W00001256,Output Areas and Small Areas,OASA,238,33,205
284019,W00001257,W00001257,Output Areas and Small Areas,OASA,220,26,194
284020,W00001258,W00001258,Output Areas and Small Areas,OASA,253,11,242
284021,W00001259,W00001259,Output Areas and Small Areas,OASA,214,33,181
284022,W00001260,W00001260,Output Areas and Small Areas,OASA,220,20,200
284023,W00001261,W00001261,Output Areas and Small Areas,OASA,223,20,203
284024,W00001262,W00001262,Output Areas and Small Areas,OASA,245,28,217
284025,W00001263,W00001263,Output Areas and Small Areas,OASA,225,18,207
284026,W00001264,W00001264,Output Areas and Small Areas,OASA,201,14,187
284027,W00001265,W00001265,Output Areas and Small Areas,OASA,248,16,232
284028,W00001266,W00001266,Output Areas and Small Areas,OASA,260,27,233
284029,W00001267,W00001267,Output Areas and Small Areas,OASA,277,41,236
284030,W00001268,W00001268,Output Areas and Small Areas,OASA,253,22,231
284031,W00001269,W00001269,Output Areas and Small Areas,OASA,279,30,249
284032,W00001270,W00001270,Output Areas and Small Areas,OASA,192,11,181
284033,W00001271,W00001271,Output Areas and Small Areas,OASA,228,19,209
284034,W00001272,W00001272,Output Areas and Small Areas,OASA,245,24,221
284035,W00001273,W00001273,Output Areas and Small Areas,OASA,247,13,234
284036,W00001274,W00001274,Output Areas and Small Areas,OASA,288,23,265
284037,W00001275,W00001275,Output Areas and Small Areas,OASA,234,26,208
284038,W00001276,W00001276,Output Areas and Small Areas,OASA,249,14,235
284039,W00001277,W00001277,Output Areas and Small Areas,OASA,290,27,263
284040,W00001278,W00001278,Output Areas and Small Areas,OASA,204,10,194
284041,W00001279,W00001279,Output Areas and Small Areas,OASA,167,10,157
284042,W00001280,W00001280,Output Areas and Small Areas,OASA,249,18,231
284043,W00001281,W00001281,Output Areas and Small Areas,OASA,232,13,219
284044,W00001282,W00001282,Output Areas and Small Areas,OASA,131,8,123
284045,W00001283,W00001283,Output Areas and Small Areas,OASA,376,31,345
284046,W00001284,W00001284,Output Areas and Small Areas,OASA,175,13,162
284047,W00001285,W00001285,Output Areas and Small Areas,OASA,176,10,166
284048,W00001286,W00001286,Output Areas and Small Areas,OASA,239,19,220
284049,W00001287,W00001287,Output Areas and Small Areas,OASA,305,33,272
284050,W00001288,W00001288,Output Areas and Small Areas,OASA,274,29,245
284051,W00001289,W00001289,Output Areas and Small Areas,OASA,207,22,185
284052,W00001290,W00001290,Output Areas and Small Areas,OASA,213,20,193
284053,W00001291,W00001291,Output Areas and Small Areas,OASA,254,21,233
284054,W00001292,W00001292,Output Areas and Small Areas,OASA,137,13,124
284055,W00001293,W00001293,Output Areas and Small Areas,OASA,155,16,139
284056,W00001294,W00001294,Output Areas and Small Areas,OASA,243,110,133
284057,W00001295,W00001295,Output Areas and Small Areas,OASA,226,98,128
284058,W00001296,W00001296,Output Areas and Small Areas,OASA,245,80,165
284059,W00001297,W00001297,Output Areas and Small Areas,OASA,191,69,122
284060,W00001298,W00001298,Output Areas and Small Areas,OASA,183,67,116
284061,W00001299,W00001299,Output Areas and Small Areas,OASA,205,76,129
284062,W00001300,W00001300,Output Areas and Small Areas,OASA,208,53,155
284063,W00001301,W00001301,Output Areas and Small Areas,OASA,286,87,199
284064,W00001302,W00001302,Output Areas and Small Areas,OASA,241,99,142
284065,W00001303,W00001303,Output Areas and Small Areas,OASA,241,79,162
284066,W00001304,W00001304,Output Areas and Small Areas,OASA,230,102,128
284067,W00001305,W00001305,Output Areas and Small Areas,OASA,180,91,89
284068,W00001306,W00001306,Output Areas and Small Areas,OASA,271,127,144
284069,W00001307,W00001307,Output Areas and Small Areas,OASA,231,124,107
284070,W00001308,W00001308,Output Areas and Small Areas,OASA,236,110,126
284071,W00001309,W00001309,Output Areas and Small Areas,OASA,251,105,146
284072,W00001310,W00001310,Output Areas and Small Areas,OASA,336,125,211
284073,W00001311,W00001311,Output Areas and Small Areas,OASA,200,72,128
284074,W00001312,W00001312,Output Areas and Small Areas,OASA,260,113,147
284075,W00001313,W00001313,Output Areas and Small Areas,OASA,185,27,158
284076,W00001314,W00001314,Output Areas and Small Areas,OASA,232,69,163
284077,W00001315,W00001315,Output Areas and Small Areas,OASA,234,56,178
284078,W00001316,W00001316,Output Areas and Small Areas,OASA,228,46,182
284079,W00001317,W00001317,Output Areas and Small Areas,OASA,282,73,209
284080,W00001318,W00001318,Output Areas and Small Areas,OASA,234,55,179
284081,W00001319,W00001319,Output Areas and Small Areas,OASA,218,44,174
284082,W00001320,W00001320,Output Areas and Small Areas,OASA,216,50,166
284083,W00001321,W00001321,Output Areas and Small Areas,OASA,194,29,165
284084,W00001322,W00001322,Output Areas and Small Areas,OASA,231,41,190
284085,W00001323,W00001323,Output Areas and Small Areas,OASA,241,29,212
284086,W00001324,W00001324,Output Areas and Small Areas,OASA,288,51,237
284087,W00001325,W00001325,Output Areas and Small Areas,OASA,340,91,249
284088,W00001326,W00001326,Output Areas and Small Areas,OASA,239,73,166
284089,W00001327,W00001327,Output Areas and Small Areas,OASA,268,58,210
284090,W00001328,W00001328,Output Areas and Small Areas,OASA,276,78,198
284091,W00001329,W00001329,Output Areas and Small Areas,OASA,314,68,246
284092,W00001330,W00001330,Output Areas and Small Areas,OASA,226,63,163
284093,W00001331,W00001331,Output Areas and Small Areas,OASA,282,61,221
284094,W00001332,W00001332,Output Areas and Small Areas,OASA,297,77,220
284095,W00001333,W00001333,Output Areas and Small Areas,OASA,280,87,193
284096,W00001334,W00001334,Output Areas and Small Areas,OASA,302,75,227
284097,W00001335,W00001335,Output Areas and Small Areas,OASA,209,52,157
284098,W00001336,W00001336,Output Areas and Small Areas,OASA,259,37,222
284099,W00001337,W00001337,Output Areas and Small Areas,OASA,267,34,233
284100,W00001338,W00001338,Output Areas and Small Areas,OASA,266,41,225
284101,W00001339,W00001339,Output Areas and Small Areas,OASA,253,26,227
284102,W00001340,W00001340,Output Areas and Small Areas,OASA,302,31,271
284103,W00001341,W00001341,Output Areas and Small Areas,OASA,228,26,202
284104,W00001342,W00001342,Output Areas and Small Areas,OASA,244,19,225
284105,W00001343,W00001343,Output Areas and Small Areas,OASA,273,37,236
284106,W00001344,W00001344,Output Areas and Small Areas,OASA,252,27,225
284107,W00001345,W00001345,Output Areas and Small Areas,OASA,270,15,255
284108,W00001346,W00001346,Output Areas and Small Areas,OASA,217,13,204
284109,W00001347,W00001347,Output Areas and Small Areas,OASA,256,13,243
284110,W00001348,W00001348,Output Areas and Small Areas,OASA,220,10,210
284111,W00001349,W00001349,Output Areas and Small Areas,OASA,218,16,202
284112,W00001350,W00001350,Output Areas and Small Areas,OASA,267,22,245
284113,W00001351,W00001351,Output Areas and Small Areas,OASA,209,11,198
284114,W00001352,W00001352,Output Areas and Small Areas,OASA,217,10,207
284115,W00001353,W00001353,Output Areas and Small Areas,OASA,239,7,232
284116,W00001354,W00001354,Output Areas and Small Areas,OASA,232,12,220
284117,W00001355,W00001355,Output Areas and Small Areas,OASA,266,11,255
284118,W00001356,W00001356,Output Areas and Small Areas,OASA,360,30,330
284119,W00001357,W00001357,Output Areas and Small Areas,OASA,249,16,233
284120,W00001358,W00001358,Output Areas and Small Areas,OASA,263,25,238
284121,W00001359,W00001359,Output Areas and Small Areas,OASA,178,28,150
284122,W00001360,W00001360,Output Areas and Small Areas,OASA,298,19,279
284123,W00001361,W00001361,Output Areas and Small Areas,OASA,218,15,203
284124,W00001362,W00001362,Output Areas and Small Areas,OASA,294,25,269
284125,W00001363,W00001363,Output Areas and Small Areas,OASA,238,19,219
284126,W00001364,W00001364,Output Areas and Small Areas,OASA,223,28,195
284127,W00001365,W00001365,Output Areas and Small Areas,OASA,250,28,222
284128,W00001366,W00001366,Output Areas and Small Areas,OASA,237,23,214
284129,W00001367,W00001367,Output Areas and Small Areas,OASA,246,29,217
284130,W00001368,W00001368,Output Areas and Small Areas,OASA,247,19,228
284131,W00001369,W00001369,Output Areas and Small Areas,OASA,223,8,215
284132,W00001370,W00001370,Output Areas and Small Areas,OASA,253,10,243
284133,W00001371,W00001371,Output Areas and Small Areas,OASA,234,13,221
284134,W00001372,W00001372,Output Areas and Small Areas,OASA,253,13,240
284135,W00001373,W00001373,Output Areas and Small Areas,OASA,394,21,373
284136,W00001374,W00001374,Output Areas and Small Areas,OASA,245,6,239
284137,W00001375,W00001375,Output Areas and Small Areas,OASA,277,19,258
284138,W00001376,W00001376,Output Areas and Small Areas,OASA,292,9,283
284139,W00001377,W00001377,Output Areas and Small Areas,OASA,242,14,228
284140,W00001378,W00001378,Output Areas and Small Areas,OASA,243,9,234
284141,W00001379,W00001379,Output Areas and Small Areas,OASA,255,14,241
284142,W00001380,W00001380,Output Areas and Small Areas,OASA,246,11,235
284143,W00001381,W00001381,Output Areas and Small Areas,OASA,230,17,213
284144,W00001382,W00001382,Output Areas and Small Areas,OASA,225,9,216
284145,W00001383,W00001383,Output Areas and Small Areas,OASA,251,12,239
284146,W00001384,W00001384,Output Areas and Small Areas,OASA,236,15,221
284147,W00001385,W00001385,Output Areas and Small Areas,OASA,272,14,258
284148,W00001386,W00001386,Output Areas and Small Areas,OASA,242,13,229
284149,W00001387,W00001387,Output Areas and Small Areas,OASA,263,18,245
284150,W00001388,W00001388,Output Areas and Small Areas,OASA,306,46,260
284151,W00001389,W00001389,Output Areas and Small Areas,OASA,303,57,246
284152,W00001390,W00001390,Output Areas and Small Areas,OASA,291,51,240
284153,W00001391,W00001391,Output Areas and Small Areas,OASA,371,45,326
284154,W00001392,W00001392,Output Areas and Small Areas,OASA,239,34,205
284155,W00001393,W00001393,Output Areas and Small Areas,OASA,119,25,94
284156,W00001394,W00001394,Output Areas and Small Areas,OASA,200,23,177
284157,W00001395,W00001395,Output Areas and Small Areas,OASA,266,17,249
284158,W00001396,W00001396,Output Areas and Small Areas,OASA,220,5,215
284159,W00001397,W00001397,Output Areas and Small Areas,OASA,248,16,232
284160,W00001398,W00001398,Output Areas and Small Areas,OASA,194,7,187
284161,W00001399,W00001399,Output Areas and Small Areas,OASA,249,13,236
284162,W00001400,W00001400,Output Areas and Small Areas,OASA,234,29,205
284163,W00001401,W00001401,Output Areas and Small Areas,OASA,283,13,270
284164,W00001402,W00001402,Output Areas and Small Areas,OASA,229,20,209
284165,W00001403,W00001403,Output Areas and Small Areas,OASA,228,9,219
284166,W00001404,W00001404,Output Areas and Small Areas,OASA,197,11,186
284167,W00001405,W00001405,Output Areas and Small Areas,OASA,264,24,240
284168,W00001406,W00001406,Output Areas and Small Areas,OASA,254,14,240
284169,W00001407,W00001407,Output Areas and Small Areas,OASA,219,13,206
284170,W00001408,W00001408,Output Areas and Small Areas,OASA,312,15,297
284171,W00001409,W00001409,Output Areas and Small Areas,OASA,245,13,232
284172,W00001410,W00001410,Output Areas and Small Areas,OASA,266,16,250
284173,W00001411,W00001411,Output Areas and Small Areas,OASA,144,5,139
284174,W00001412,W00001412,Output Areas and Small Areas,OASA,189,18,171
284175,W00001413,W00001413,Output Areas and Small Areas,OASA,310,27,283
284176,W00001414,W00001414,Output Areas and Small Areas,OASA,246,10,236
284177,W00001415,W00001415,Output Areas and Small Areas,OASA,205,8,197
284178,W00001416,W00001416,Output Areas and Small Areas,OASA,284,20,264
284179,W00001417,W00001417,Output Areas and Small Areas,OASA,264,11,253
284180,W00001418,W00001418,Output Areas and Small Areas,OASA,239,20,219
284181,W00001419,W00001419,Output Areas and Small Areas,OASA,288,24,264
284182,W00001420,W00001420,Output Areas and Small Areas,OASA,234,15,219
284183,W00001421,W00001421,Output Areas and Small Areas,OASA,204,17,187
284184,W00001422,W00001422,Output Areas and Small Areas,OASA,236,20,216
284185,W00001423,W00001423,Output Areas and Small Areas,OASA,410,38,372
284186,W00001424,W00001424,Output Areas and Small Areas,OASA,218,13,205
284187,W00001425,W00001425,Output Areas and Small Areas,OASA,195,14,181
284188,W00001426,W00001426,Output Areas and Small Areas,OASA,261,22,239
284189,W00001427,W00001427,Output Areas and Small Areas,OASA,336,25,311
284190,W00001428,W00001428,Output Areas and Small Areas,OASA,223,10,213
284191,W00001429,W00001429,Output Areas and Small Areas,OASA,330,31,299
284192,W00001430,W00001430,Output Areas and Small Areas,OASA,205,17,188
284193,W00001431,W00001431,Output Areas and Small Areas,OASA,231,15,216
284194,W00001432,W00001432,Output Areas and Small Areas,OASA,240,10,230
284195,W00001433,W00001433,Output Areas and Small Areas,OASA,228,18,210
284196,W00001434,W00001434,Output Areas and Small Areas,OASA,237,11,226
284197,W00001435,W00001435,Output Areas and Small Areas,OASA,260,15,245
284198,W00001436,W00001436,Output Areas and Small Areas,OASA,327,24,303
284199,W00001437,W00001437,Output Areas and Small Areas,OASA,182,14,168
284200,W00001438,W00001438,Output Areas and Small Areas,OASA,332,28,304
284201,W00001439,W00001439,Output Areas and Small Areas,OASA,247,8,239
284202,W00001440,W00001440,Output Areas and Small Areas,OASA,313,13,300
284203,W00001441,W00001441,Output Areas and Small Areas,OASA,277,23,254
284204,W00001442,W00001442,Output Areas and Small Areas,OASA,339,31,308
284205,W00001443,W00001443,Output Areas and Small Areas,OASA,325,32,293
284206,W00001444,W00001444,Output Areas and Small Areas,OASA,245,8,237
284207,W00001445,W00001445,Output Areas and Small Areas,OASA,241,27,214
284208,W00001446,W00001446,Output Areas and Small Areas,OASA,261,24,237
284209,W00001447,W00001447,Output Areas and Small Areas,OASA,202,17,185
284210,W00001448,W00001448,Output Areas and Small Areas,OASA,213,22,191
284211,W00001449,W00001449,Output Areas and Small Areas,OASA,180,15,165
284212,W00001450,W00001450,Output Areas and Small Areas,OASA,265,23,242
284213,W00001451,W00001451,Output Areas and Small Areas,OASA,170,23,147
284214,W00001452,W00001452,Output Areas and Small Areas,OASA,216,35,181
284215,W00001453,W00001453,Output Areas and Small Areas,OASA,232,49,183
284216,W00001454,W00001454,Output Areas and Small Areas,OASA,103,24,79
284217,W00001455,W00001455,Output Areas and Small Areas,OASA,138,18,120
284218,W00001456,W00001456,Output Areas and Small Areas,OASA,214,38,176
284219,W00001457,W00001457,Output Areas and Small Areas,OASA,284,51,233
284220,W00001458,W00001458,Output Areas and Small Areas,OASA,285,41,244
284221,W00001459,W00001459,Output Areas and Small Areas,OASA,281,61,220
284222,W00001460,W00001460,Output Areas and Small Areas,OASA,242,46,196
284223,W00001461,W00001461,Output Areas and Small Areas,OASA,257,30,227
284224,W00001462,W00001462,Output Areas and Small Areas,OASA,358,58,300
284225,W00001463,W00001463,Output Areas and Small Areas,OASA,355,66,289
284226,W00001464,W00001464,Output Areas and Small Areas,OASA,204,27,177
284227,W00001465,W00001465,Output Areas and Small Areas,OASA,229,28,201
284228,W00001466,W00001466,Output Areas and Small Areas,OASA,191,16,175
284229,W00001467,W00001467,Output Areas and Small Areas,OASA,205,7,198
284230,W00001468,W00001468,Output Areas and Small Areas,OASA,264,25,239
284231,W00001469,W00001469,Output Areas and Small Areas,OASA,207,7,200
284232,W00001470,W00001470,Output Areas and Small Areas,OASA,288,11,277
284233,W00001471,W00001471,Output Areas and Small Areas,OASA,175,7,168
284234,W00001472,W00001472,Output Areas and Small Areas,OASA,220,12,208
284235,W00001473,W00001473,Output Areas and Small Areas,OASA,260,18,242
284236,W00001474,W00001474,Output Areas and Small Areas,OASA,257,15,242
284237,W00001475,W00001475,Output Areas and Small Areas,OASA,164,8,156
284238,W00001476,W00001476,Output Areas and Small Areas,OASA,222,8,214
284239,W00001477,W00001477,Output Areas and Small Areas,OASA,174,8,166
284240,W00001478,W00001478,Output Areas and Small Areas,OASA,233,4,229
284241,W00001479,W00001479,Output Areas and Small Areas,OASA,283,20,263
284242,W00001480,W00001480,Output Areas and Small Areas,OASA,235,14,221
284243,W00001481,W00001481,Output Areas and Small Areas,OASA,248,20,228
284244,W00001482,W00001482,Output Areas and Small Areas,OASA,263,13,250
284245,W00001483,W00001483,Output Areas and Small Areas,OASA,234,16,218
284246,W00001484,W00001484,Output Areas and Small Areas,OASA,248,17,231
284247,W00001485,W00001485,Output Areas and Small Areas,OASA,275,18,257
284248,W00001486,W00001486,Output Areas and Small Areas,OASA,239,14,225
284249,W00001487,W00001487,Output Areas and Small Areas,OASA,247,18,229
284250,W00001488,W00001488,Output Areas and Small Areas,OASA,248,20,228
284251,W00001489,W00001489,Output Areas and Small Areas,OASA,326,25,301
284252,W00001490,W00001490,Output Areas and Small Areas,OASA,239,20,219
284253,W00001491,W00001491,Output Areas and Small Areas,OASA,133,1,132
284254,W00001492,W00001492,Output Areas and Small Areas,OASA,259,16,243
284255,W00001493,W00001493,Output Areas and Small Areas,OASA,255,24,231
284256,W00001494,W00001494,Output Areas and Small Areas,OASA,250,16,234
284257,W00001495,W00001495,Output Areas and Small Areas,OASA,267,14,253
284258,W00001496,W00001496,Output Areas and Small Areas,OASA,223,14,209
284259,W00001497,W00001497,Output Areas and Small Areas,OASA,303,23,280
284260,W00001498,W00001498,Output Areas and Small Areas,OASA,206,3,203
284261,W00001499,W00001499,Output Areas and Small Areas,OASA,233,17,216
284262,W00001500,W00001500,Output Areas and Small Areas,OASA,270,16,254
284263,W00001501,W00001501,Output Areas and Small Areas,OASA,266,22,244
284264,W00001502,W00001502,Output Areas and Small Areas,OASA,248,13,235
284265,W00001503,W00001503,Output Areas and Small Areas,OASA,220,14,206
284266,W00001504,W00001504,Output Areas and Small Areas,OASA,246,15,231
284267,W00001505,W00001505,Output Areas and Small Areas,OASA,278,13,265
284268,W00001506,W00001506,Output Areas and Small Areas,OASA,310,11,299
284269,W00001507,W00001507,Output Areas and Small Areas,OASA,241,15,226
284270,W00001508,W00001508,Output Areas and Small Areas,OASA,339,32,307
284271,W00001509,W00001509,Output Areas and Small Areas,OASA,265,33,232
284272,W00001510,W00001510,Output Areas and Small Areas,OASA,392,27,365
284273,W00001511,W00001511,Output Areas and Small Areas,OASA,255,15,240
284274,W00001512,W00001512,Output Areas and Small Areas,OASA,238,15,223
284275,W00001513,W00001513,Output Areas and Small Areas,OASA,279,16,263
284276,W00001514,W00001514,Output Areas and Small Areas,OASA,251,13,238
284277,W00001515,W00001515,Output Areas and Small Areas,OASA,335,23,312
284278,W00001516,W00001516,Output Areas and Small Areas,OASA,253,16,237
284279,W00001517,W00001517,Output Areas and Small Areas,OASA,256,14,242
284280,W00001518,W00001518,Output Areas and Small Areas,OASA,245,15,230
284281,W00001519,W00001519,Output Areas and Small Areas,OASA,240,11,229
284282,W00001520,W00001520,Output Areas and Small Areas,OASA,283,16,267
284283,W00001521,W00001521,Output Areas and Small Areas,OASA,318,23,295
284284,W00001522,W00001522,Output Areas and Small Areas,OASA,244,11,233
284285,W00001523,W00001523,Output Areas and Small Areas,OASA,231,10,221
284286,W00001524,W00001524,Output Areas and Small Areas,OASA,287,20,267
284287,W00001525,W00001525,Output Areas and Small Areas,OASA,281,13,268
284288,W00001526,W00001526,Output Areas and Small Areas,OASA,329,22,307
284289,W00001527,W00001527,Output Areas and Small Areas,OASA,280,16,264
284290,W00001528,W00001528,Output Areas and Small Areas,OASA,256,13,243
284291,W00001530,W00001530,Output Areas and Small Areas,OASA,225,16,209
284292,W00001531,W00001531,Output Areas and Small Areas,OASA,332,31,301
284293,W00001532,W00001532,Output Areas and Small Areas,OASA,258,22,236
284294,W00001533,W00001533,Output Areas and Small Areas,OASA,290,24,266
284295,W00001534,W00001534,Output Areas and Small Areas,OASA,194,13,181
284296,W00001535,W00001535,Output Areas and Small Areas,OASA,366,98,268
284297,W00001536,W00001536,Output Areas and Small Areas,OASA,188,16,172
284298,W00001537,W00001537,Output Areas and Small Areas,OASA,169,17,152
284299,W00001538,W00001538,Output Areas and Small Areas,OASA,263,44,219
284300,W00001539,W00001539,Output Areas and Small Areas,OASA,188,46,142
284301,W00001540,W00001540,Output Areas and Small Areas,OASA,228,56,172
284302,W00001541,W00001541,Output Areas and Small Areas,OASA,126,6,120
284303,W00001542,W00001542,Output Areas and Small Areas,OASA,238,21,217
284304,W00001543,W00001543,Output Areas and Small Areas,OASA,177,20,157
284305,W00001544,W00001544,Output Areas and Small Areas,OASA,177,8,169
284306,W00001545,W00001545,Output Areas and Small Areas,OASA,241,20,221
284307,W00001546,W00001546,Output Areas and Small Areas,OASA,236,25,211
284308,W00001547,W00001547,Output Areas and Small Areas,OASA,232,19,213
284309,W00001548,W00001548,Output Areas and Small Areas,OASA,222,8,214
284310,W00001549,W00001549,Output Areas and Small Areas,OASA,259,15,244
284311,W00001550,W00001550,Output Areas and Small Areas,OASA,303,20,283
284312,W00001551,W00001551,Output Areas and Small Areas,OASA,221,26,195
284313,W00001552,W00001552,Output Areas and Small Areas,OASA,244,16,228
284314,W00001553,W00001553,Output Areas and Small Areas,OASA,238,19,219
284315,W00001554,W00001554,Output Areas and Small Areas,OASA,205,19,186
284316,W00001555,W00001555,Output Areas and Small Areas,OASA,311,32,279
284317,W00001556,W00001556,Output Areas and Small Areas,OASA,217,18,199
284318,W00001557,W00001557,Output Areas and Small Areas,OASA,230,22,208
284319,W00001558,W00001558,Output Areas and Small Areas,OASA,188,21,167
284320,W00001559,W00001559,Output Areas and Small Areas,OASA,287,18,269
284321,W00001560,W00001560,Output Areas and Small Areas,OASA,207,17,190
284322,W00001561,W00001561,Output Areas and Small Areas,OASA,179,15,164
284323,W00001562,W00001562,Output Areas and Small Areas,OASA,188,11,177
284324,W00001563,W00001563,Output Areas and Small Areas,OASA,246,25,221
284325,W00001564,W00001564,Output Areas and Small Areas,OASA,279,32,247
284326,W00001565,W00001565,Output Areas and Small Areas,OASA,272,27,245
284327,W00001566,W00001566,Output Areas and Small Areas,OASA,257,19,238
284328,W00001567,W00001567,Output Areas and Small Areas,OASA,302,21,281
284329,W00001568,W00001568,Output Areas and Small Areas,OASA,275,11,264
284330,W00001569,W00001569,Output Areas and Small Areas,OASA,266,20,246
284331,W00001570,W00001570,Output Areas and Small Areas,OASA,284,32,252
284332,W00001571,W00001571,Output Areas and Small Areas,OASA,280,18,262
284333,W00001572,W00001572,Output Areas and Small Areas,OASA,170,16,154
284334,W00001573,W00001573,Output Areas and Small Areas,OASA,415,45,370
284335,W00001574,W00001574,Output Areas and Small Areas,OASA,240,15,225
284336,W00001575,W00001575,Output Areas and Small Areas,OASA,93,8,85
284337,W00001576,W00001576,Output Areas and Small Areas,OASA,289,22,267
284338,W00001577,W00001577,Output Areas and Small Areas,OASA,391,46,345
284339,W00001578,W00001578,Output Areas and Small Areas,OASA,257,23,234
284340,W00001579,W00001579,Output Areas and Small Areas,OASA,275,21,254
284341,W00001580,W00001580,Output Areas and Small Areas,OASA,322,17,305
284342,W00001581,W00001581,Output Areas and Small Areas,OASA,327,31,296
284343,W00001582,W00001582,Output Areas and Small Areas,OASA,324,28,296
284344,W00001583,W00001583,Output Areas and Small Areas,OASA,323,29,294
284345,W00001584,W00001584,Output Areas and Small Areas,OASA,278,27,251
284346,W00001585,W00001585,Output Areas and Small Areas,OASA,166,11,155
284347,W00001586,W00001586,Output Areas and Small Areas,OASA,225,13,212
284348,W00001587,W00001587,Output Areas and Small Areas,OASA,234,18,216
284349,W00001588,W00001588,Output Areas and Small Areas,OASA,223,15,208
284350,W00001589,W00001589,Output Areas and Small Areas,OASA,276,21,255
284351,W00001590,W00001590,Output Areas and Small Areas,OASA,199,21,178
284352,W00001591,W00001591,Output Areas and Small Areas,OASA,207,15,192
284353,W00001592,W00001592,Output Areas and Small Areas,OASA,228,21,207
284354,W00001593,W00001593,Output Areas and Small Areas,OASA,160,21,139
284355,W00001594,W00001594,Output Areas and Small Areas,OASA,185,16,169
284356,W00001595,W00001595,Output Areas and Small Areas,OASA,231,25,206
284357,W00001596,W00001596,Output Areas and Small Areas,OASA,244,34,210
284358,W00001597,W00001597,Output Areas and Small Areas,OASA,211,26,185
284359,W00001598,W00001598,Output Areas and Small Areas,OASA,265,32,233
284360,W00001599,W00001599,Output Areas and Small Areas,OASA,226,23,203
284361,W00001600,W00001600,Output Areas and Small Areas,OASA,217,26,191
284362,W00001601,W00001601,Output Areas and Small Areas,OASA,274,26,248
284363,W00001602,W00001602,Output Areas and Small Areas,OASA,218,29,189
284364,W00001603,W00001603,Output Areas and Small Areas,OASA,177,22,155
284365,W00001604,W00001604,Output Areas and Small Areas,OASA,272,44,228
284366,W00001605,W00001605,Output Areas and Small Areas,OASA,447,57,390
284367,W00001608,W00001608,Output Areas and Small Areas,OASA,155,18,137
284368,W00001609,W00001609,Output Areas and Small Areas,OASA,264,64,200
284369,W00001610,W00001610,Output Areas and Small Areas,OASA,227,45,182
284370,W00001611,W00001611,Output Areas and Small Areas,OASA,238,32,206
284371,W00001612,W00001612,Output Areas and Small Areas,OASA,281,43,238
284372,W00001613,W00001613,Output Areas and Small Areas,OASA,268,55,213
284373,W00001614,W00001614,Output Areas and Small Areas,OASA,260,34,226
284374,W00001615,W00001615,Output Areas and Small Areas,OASA,248,64,184
284375,W00001616,W00001616,Output Areas and Small Areas,OASA,194,35,159
284376,W00001617,W00001617,Output Areas and Small Areas,OASA,426,25,401
284377,W00001618,W00001618,Output Areas and Small Areas,OASA,159,11,148
284378,W00001619,W00001619,Output Areas and Small Areas,OASA,264,16,248
284379,W00001620,W00001620,Output Areas and Small Areas,OASA,197,20,177
284380,W00001621,W00001621,Output Areas and Small Areas,OASA,182,5,177
284381,W00001622,W00001622,Output Areas and Small Areas,OASA,212,14,198
284382,W00001623,W00001623,Output Areas and Small Areas,OASA,141,5,136
284383,W00001624,W00001624,Output Areas and Small Areas,OASA,303,23,280
284384,W00001625,W00001625,Output Areas and Small Areas,OASA,292,16,276
284385,W00001626,W00001626,Output Areas and Small Areas,OASA,259,23,236
284386,W00001627,W00001627,Output Areas and Small Areas,OASA,265,15,250
284387,W00001628,W00001628,Output Areas and Small Areas,OASA,240,14,226
284388,W00001629,W00001629,Output Areas and Small Areas,OASA,283,30,253
284389,W00001630,W00001630,Output Areas and Small Areas,OASA,205,24,181
284390,W00001631,W00001631,Output Areas and Small Areas,OASA,204,27,177
284391,W00001632,W00001632,Output Areas and Small Areas,OASA,201,7,194
284392,W00001633,W00001633,Output Areas and Small Areas,OASA,220,18,202
284393,W00001634,W00001634,Output Areas and Small Areas,OASA,247,13,234
284394,W00001635,W00001635,Output Areas and Small Areas,OASA,191,22,169
284395,W00001636,W00001636,Output Areas and Small Areas,OASA,235,33,202
284396,W00001637,W00001637,Output Areas and Small Areas,OASA,244,46,198
284397,W00001638,W00001638,Output Areas and Small Areas,OASA,227,29,198
284398,W00001639,W00001639,Output Areas and Small Areas,OASA,218,17,201
284399,W00001640,W00001640,Output Areas and Small Areas,OASA,224,27,197
284400,W00001641,W00001641,Output Areas and Small Areas,OASA,281,25,256
284401,W00001642,W00001642,Output Areas and Small Areas,OASA,238,34,204
284402,W00001643,W00001643,Output Areas and Small Areas,OASA,322,34,288
284403,W00001644,W00001644,Output Areas and Small Areas,OASA,275,33,242
284404,W00001645,W00001645,Output Areas and Small Areas,OASA,228,17,211
284405,W00001646,W00001646,Output Areas and Small Areas,OASA,247,35,212
284406,W00001647,W00001647,Output Areas and Small Areas,OASA,301,44,257
284407,W00001648,W00001648,Output Areas and Small Areas,OASA,319,62,257
284408,W00001649,W00001649,Output Areas and Small Areas,OASA,261,19,242
284409,W00001650,W00001650,Output Areas and Small Areas,OASA,254,25,229
284410,W00001651,W00001651,Output Areas and Small Areas,OASA,257,24,233
284411,W00001652,W00001652,Output Areas and Small Areas,OASA,186,25,161
284412,W00001653,W00001653,Output Areas and Small Areas,OASA,166,9,157
284413,W00001654,W00001654,Output Areas and Small Areas,OASA,266,25,241
284414,W00001655,W00001655,Output Areas and Small Areas,OASA,233,27,206
284415,W00001656,W00001656,Output Areas and Small Areas,OASA,266,34,232
284416,W00001657,W00001657,Output Areas and Small Areas,OASA,230,17,213
284417,W00001658,W00001658,Output Areas and Small Areas,OASA,264,30,234
284418,W00001659,W00001659,Output Areas and Small Areas,OASA,241,26,215
284419,W00001660,W00001660,Output Areas and Small Areas,OASA,226,26,200
284420,W00001661,W00001661,Output Areas and Small Areas,OASA,272,43,229
284421,W00001662,W00001662,Output Areas and Small Areas,OASA,182,12,170
284422,W00001663,W00001663,Output Areas and Small Areas,OASA,248,33,215
284423,W00001664,W00001664,Output Areas and Small Areas,OASA,292,36,256
284424,W00001665,W00001665,Output Areas and Small Areas,OASA,181,31,150
284425,W00001666,W00001666,Output Areas and Small Areas,OASA,203,11,192
284426,W00001667,W00001667,Output Areas and Small Areas,OASA,329,30,299
284427,W00001668,W00001668,Output Areas and Small Areas,OASA,231,19,212
284428,W00001669,W00001669,Output Areas and Small Areas,OASA,317,59,258
284429,W00001670,W00001670,Output Areas and Small Areas,OASA,293,48,245
284430,W00001671,W00001671,Output Areas and Small Areas,OASA,254,21,233
284431,W00001672,W00001672,Output Areas and Small Areas,OASA,272,26,246
284432,W00001674,W00001674,Output Areas and Small Areas,OASA,284,18,266
284433,W00001675,W00001675,Output Areas and Small Areas,OASA,253,17,236
284434,W00001676,W00001676,Output Areas and Small Areas,OASA,225,8,217
284435,W00001677,W00001677,Output Areas and Small Areas,OASA,221,20,201
284436,W00001678,W00001678,Output Areas and Small Areas,OASA,202,8,194
284437,W00001679,W00001679,Output Areas and Small Areas,OASA,213,11,202
284438,W00001680,W00001680,Output Areas and Small Areas,OASA,309,19,290
284439,W00001681,W00001681,Output Areas and Small Areas,OASA,261,14,247
284440,W00001683,W00001683,Output Areas and Small Areas,OASA,218,35,183
284441,W00001684,W00001684,Output Areas and Small Areas,OASA,250,25,225
284442,W00001685,W00001685,Output Areas and Small Areas,OASA,231,44,187
284443,W00001686,W00001686,Output Areas and Small Areas,OASA,242,44,198
284444,W00001687,W00001687,Output Areas and Small Areas,OASA,257,45,212
284445,W00001688,W00001688,Output Areas and Small Areas,OASA,225,32,193
284446,W00001689,W00001689,Output Areas and Small Areas,OASA,257,30,227
284447,W00001690,W00001690,Output Areas and Small Areas,OASA,266,37,229
284448,W00001691,W00001691,Output Areas and Small Areas,OASA,238,31,207
284449,W00001692,W00001692,Output Areas and Small Areas,OASA,268,52,216
284450,W00001693,W00001693,Output Areas and Small Areas,OASA,197,27,170
284451,W00001694,W00001694,Output Areas and Small Areas,OASA,213,39,174
284452,W00001695,W00001695,Output Areas and Small Areas,OASA,266,39,227
284453,W00001696,W00001696,Output Areas and Small Areas,OASA,228,30,198
284454,W00001697,W00001697,Output Areas and Small Areas,OASA,203,21,182
284455,W00001698,W00001698,Output Areas and Small Areas,OASA,276,45,231
284456,W00001699,W00001699,Output Areas and Small Areas,OASA,266,68,198
284457,W00001700,W00001700,Output Areas and Small Areas,OASA,263,55,208
284458,W00001701,W00001701,Output Areas and Small Areas,OASA,274,73,201
284459,W00001702,W00001702,Output Areas and Small Areas,OASA,329,93,236
284460,W00001703,W00001703,Output Areas and Small Areas,OASA,233,44,189
284461,W00001704,W00001704,Output Areas and Small Areas,OASA,255,81,174
284462,W00001705,W00001705,Output Areas and Small Areas,OASA,254,80,174
284463,W00001706,W00001706,Output Areas and Small Areas,OASA,304,83,221
284464,W00001707,W00001707,Output Areas and Small Areas,OASA,217,29,188
284465,W00001708,W00001708,Output Areas and Small Areas,OASA,161,21,140
284466,W00001709,W00001709,Output Areas and Small Areas,OASA,246,47,199
284467,W00001710,W00001710,Output Areas and Small Areas,OASA,246,28,218
284468,W00001711,W00001711,Output Areas and Small Areas,OASA,201,31,170
284469,W00001712,W00001712,Output Areas and Small Areas,OASA,192,30,162
284470,W00001713,W00001713,Output Areas and Small Areas,OASA,354,35,319
284471,W00001714,W00001714,Output Areas and Small Areas,OASA,235,15,220
284472,W00001715,W00001715,Output Areas and Small Areas,OASA,244,26,218
284473,W00001716,W00001716,Output Areas and Small Areas,OASA,201,24,177
284474,W00001717,W00001717,Output Areas and Small Areas,OASA,384,72,312
284475,W00001718,W00001718,Output Areas and Small Areas,OASA,200,30,170
284476,W00001719,W00001719,Output Areas and Small Areas,OASA,140,17,123
284477,W00001720,W00001720,Output Areas and Small Areas,OASA,195,25,170
284478,W00001721,W00001721,Output Areas and Small Areas,OASA,208,38,170
284479,W00001722,W00001722,Output Areas and Small Areas,OASA,163,26,137
284480,W00001723,W00001723,Output Areas and Small Areas,OASA,285,23,262
284481,W00001724,W00001724,Output Areas and Small Areas,OASA,288,24,264
284482,W00001725,W00001725,Output Areas and Small Areas,OASA,170,15,155
284483,W00001726,W00001726,Output Areas and Small Areas,OASA,135,19,116
284484,W00001727,W00001727,Output Areas and Small Areas,OASA,440,33,407
284485,W00001728,W00001728,Output Areas and Small Areas,OASA,283,29,254
284486,W00001729,W00001729,Output Areas and Small Areas,OASA,256,31,225
284487,W00001730,W00001730,Output Areas and Small Areas,OASA,226,25,201
284488,W00001731,W00001731,Output Areas and Small Areas,OASA,164,22,142
284489,W00001732,W00001732,Output Areas and Small Areas,OASA,267,26,241
284490,W00001733,W00001733,Output Areas and Small Areas,OASA,247,33,214
284491,W00001734,W00001734,Output Areas and Small Areas,OASA,248,27,221
284492,W00001735,W00001735,Output Areas and Small Areas,OASA,289,43,246
284493,W00001736,W00001736,Output Areas and Small Areas,OASA,272,33,239
284494,W00001737,W00001737,Output Areas and Small Areas,OASA,288,29,259
284495,W00001738,W00001738,Output Areas and Small Areas,OASA,178,20,158
284496,W00001739,W00001739,Output Areas and Small Areas,OASA,242,47,195
284497,W00001740,W00001740,Output Areas and Small Areas,OASA,189,21,168
284498,W00001741,W00001741,Output Areas and Small Areas,OASA,247,45,202
284499,W00001742,W00001742,Output Areas and Small Areas,OASA,297,35,262
284500,W00001743,W00001743,Output Areas and Small Areas,OASA,308,25,283
284501,W00001744,W00001744,Output Areas and Small Areas,OASA,380,36,344
284502,W00001745,W00001745,Output Areas and Small Areas,OASA,267,16,251
284503,W00001746,W00001746,Output Areas and Small Areas,OASA,157,11,146
284504,W00001747,W00001747,Output Areas and Small Areas,OASA,173,15,158
284505,W00001748,W00001748,Output Areas and Small Areas,OASA,322,22,300
284506,W00001749,W00001749,Output Areas and Small Areas,OASA,263,23,240
284507,W00001750,W00001750,Output Areas and Small Areas,OASA,272,20,252
284508,W00001751,W00001751,Output Areas and Small Areas,OASA,257,25,232
284509,W00001752,W00001752,Output Areas and Small Areas,OASA,270,17,253
284510,W00001753,W00001753,Output Areas and Small Areas,OASA,278,16,262
284511,W00001754,W00001754,Output Areas and Small Areas,OASA,265,11,254
284512,W00001755,W00001755,Output Areas and Small Areas,OASA,253,19,234
284513,W00001756,W00001756,Output Areas and Small Areas,OASA,259,11,248
284514,W00001757,W00001757,Output Areas and Small Areas,OASA,234,14,220
284515,W00001758,W00001758,Output Areas and Small Areas,OASA,256,18,238
284516,W00001759,W00001759,Output Areas and Small Areas,OASA,267,27,240
284517,W00001760,W00001760,Output Areas and Small Areas,OASA,437,23,414
284518,W00001761,W00001761,Output Areas and Small Areas,OASA,279,13,266
284519,W00001762,W00001762,Output Areas and Small Areas,OASA,229,19,210
284520,W00001763,W00001763,Output Areas and Small Areas,OASA,246,24,222
284521,W00001764,W00001764,Output Areas and Small Areas,OASA,106,5,101
284522,W00001765,W00001765,Output Areas and Small Areas,OASA,241,12,229
284523,W00001766,W00001766,Output Areas and Small Areas,OASA,213,3,210
284524,W00001767,W00001767,Output Areas and Small Areas,OASA,217,5,212
284525,W00001768,W00001768,Output Areas and Small Areas,OASA,238,11,227
284526,W00001769,W00001769,Output Areas and Small Areas,OASA,132,6,126
284527,W00001770,W00001770,Output Areas and Small Areas,OASA,271,20,251
284528,W00001771,W00001771,Output Areas and Small Areas,OASA,215,11,204
284529,W00001772,W00001772,Output Areas and Small Areas,OASA,310,9,301
284530,W00001773,W00001773,Output Areas and Small Areas,OASA,219,4,215
284531,W00001774,W00001774,Output Areas and Small Areas,OASA,254,8,246
284532,W00001775,W00001775,Output Areas and Small Areas,OASA,263,11,252
284533,W00001776,W00001776,Output Areas and Small Areas,OASA,233,11,222
284534,W00001777,W00001777,Output Areas and Small Areas,OASA,266,14,252
284535,W00001778,W00001778,Output Areas and Small Areas,OASA,375,13,362
284536,W00001779,W00001779,Output Areas and Small Areas,OASA,258,14,244
284537,W00001780,W00001780,Output Areas and Small Areas,OASA,253,9,244
284538,W00001781,W00001781,Output Areas and Small Areas,OASA,266,5,261
284539,W00001782,W00001782,Output Areas and Small Areas,OASA,280,10,270
284540,W00001783,W00001783,Output Areas and Small Areas,OASA,323,9,314
284541,W00001784,W00001784,Output Areas and Small Areas,OASA,218,5,213
284542,W00001785,W00001785,Output Areas and Small Areas,OASA,187,13,174
284543,W00001786,W00001786,Output Areas and Small Areas,OASA,250,17,233
284544,W00001787,W00001787,Output Areas and Small Areas,OASA,235,9,226
284545,W00001788,W00001788,Output Areas and Small Areas,OASA,347,10,337
284546,W00001789,W00001789,Output Areas and Small Areas,OASA,227,12,215
284547,W00001790,W00001790,Output Areas and Small Areas,OASA,339,13,326
284548,W00001791,W00001791,Output Areas and Small Areas,OASA,228,12,216
284549,W00001792,W00001792,Output Areas and Small Areas,OASA,248,12,236
284550,W00001793,W00001793,Output Areas and Small Areas,OASA,236,21,215
284551,W00001794,W00001794,Output Areas and Small Areas,OASA,301,27,274
284552,W00001795,W00001795,Output Areas and Small Areas,OASA,249,17,232
284553,W00001796,W00001796,Output Areas and Small Areas,OASA,296,19,277
284554,W00001797,W00001797,Output Areas and Small Areas,OASA,282,10,272
284555,W00001798,W00001798,Output Areas and Small Areas,OASA,239,9,230
284556,W00001799,W00001799,Output Areas and Small Areas,OASA,248,15,233
284557,W00001800,W00001800,Output Areas and Small Areas,OASA,266,11,255
284558,W00001801,W00001801,Output Areas and Small Areas,OASA,324,8,316
284559,W00001802,W00001802,Output Areas and Small Areas,OASA,259,22,237
284560,W00001803,W00001803,Output Areas and Small Areas,OASA,175,9,166
284561,W00001804,W00001804,Output Areas and Small Areas,OASA,248,16,232
284562,W00001805,W00001805,Output Areas and Small Areas,OASA,231,15,216
284563,W00001806,W00001806,Output Areas and Small Areas,OASA,292,27,265
284564,W00001807,W00001807,Output Areas and Small Areas,OASA,246,11,235
284565,W00001808,W00001808,Output Areas and Small Areas,OASA,243,10,233
284566,W00001809,W00001809,Output Areas and Small Areas,OASA,226,7,219
284567,W00001810,W00001810,Output Areas and Small Areas,OASA,302,12,290
284568,W00001811,W00001811,Output Areas and Small Areas,OASA,231,19,212
284569,W00001812,W00001812,Output Areas and Small Areas,OASA,224,20,204
284570,W00001813,W00001813,Output Areas and Small Areas,OASA,110,25,85
284571,W00001815,W00001815,Output Areas and Small Areas,OASA,190,33,157
284572,W00001816,W00001816,Output Areas and Small Areas,OASA,253,71,182
284573,W00001817,W00001817,Output Areas and Small Areas,OASA,242,63,179
284574,W00001818,W00001818,Output Areas and Small Areas,OASA,209,42,167
284575,W00001819,W00001819,Output Areas and Small Areas,OASA,231,59,172
284576,W00001820,W00001820,Output Areas and Small Areas,OASA,236,40,196
284577,W00001821,W00001821,Output Areas and Small Areas,OASA,244,50,194
284578,W00001822,W00001822,Output Areas and Small Areas,OASA,419,93,326
284579,W00001823,W00001823,Output Areas and Small Areas,OASA,223,37,186
284580,W00001824,W00001824,Output Areas and Small Areas,OASA,338,61,277
284581,W00001825,W00001825,Output Areas and Small Areas,OASA,175,33,142
284582,W00001826,W00001826,Output Areas and Small Areas,OASA,162,15,147
284583,W00001827,W00001827,Output Areas and Small Areas,OASA,253,60,193
284584,W00001828,W00001828,Output Areas and Small Areas,OASA,276,40,236
284585,W00001829,W00001829,Output Areas and Small Areas,OASA,246,49,197
284586,W00001830,W00001830,Output Areas and Small Areas,OASA,211,29,182
284587,W00001831,W00001831,Output Areas and Small Areas,OASA,259,33,226
284588,W00001832,W00001832,Output Areas and Small Areas,OASA,233,12,221
284589,W00001833,W00001833,Output Areas and Small Areas,OASA,169,13,156
284590,W00001834,W00001834,Output Areas and Small Areas,OASA,216,11,205
284591,W00001835,W00001835,Output Areas and Small Areas,OASA,249,19,230
284592,W00001836,W00001836,Output Areas and Small Areas,OASA,266,19,247
284593,W00001837,W00001837,Output Areas and Small Areas,OASA,332,42,290
284594,W00001838,W00001838,Output Areas and Small Areas,OASA,204,17,187
284595,W00001839,W00001839,Output Areas and Small Areas,OASA,235,22,213
284596,W00001840,W00001840,Output Areas and Small Areas,OASA,240,12,228
284597,W00001841,W00001841,Output Areas and Small Areas,OASA,233,18,215
284598,W00001842,W00001842,Output Areas and Small Areas,OASA,206,19,187
284599,W00001843,W00001843,Output Areas and Small Areas,OASA,225,11,214
284600,W00001844,W00001844,Output Areas and Small Areas,OASA,242,13,229
284601,W00001845,W00001845,Output Areas and Small Areas,OASA,210,25,185
284602,W00001846,W00001846,Output Areas and Small Areas,OASA,251,28,223
284603,W00001847,W00001847,Output Areas and Small Areas,OASA,217,17,200
284604,W00001848,W00001848,Output Areas and Small Areas,OASA,203,25,178
284605,W00001849,W00001849,Output Areas and Small Areas,OASA,230,19,211
284606,W00001850,W00001850,Output Areas and Small Areas,OASA,261,15,246
284607,W00001851,W00001851,Output Areas and Small Areas,OASA,196,13,183
284608,W00001852,W00001852,Output Areas and Small Areas,OASA,217,16,201
284609,W00001853,W00001853,Output Areas and Small Areas,OASA,283,15,268
284610,W00001854,W00001854,Output Areas and Small Areas,OASA,233,13,220
284611,W00001855,W00001855,Output Areas and Small Areas,OASA,214,21,193
284612,W00001856,W00001856,Output Areas and Small Areas,OASA,280,21,259
284613,W00001857,W00001857,Output Areas and Small Areas,OASA,245,9,236
284614,W00001858,W00001858,Output Areas and Small Areas,OASA,251,6,245
284615,W00001859,W00001859,Output Areas and Small Areas,OASA,229,12,217
284616,W00001860,W00001860,Output Areas and Small Areas,OASA,299,13,286
284617,W00001861,W00001861,Output Areas and Small Areas,OASA,382,10,372
284618,W00001862,W00001862,Output Areas and Small Areas,OASA,225,26,199
284619,W00001863,W00001863,Output Areas and Small Areas,OASA,207,9,198
284620,W00001864,W00001864,Output Areas and Small Areas,OASA,219,29,190
284621,W00001866,W00001866,Output Areas and Small Areas,OASA,338,36,302
284622,W00001867,W00001867,Output Areas and Small Areas,OASA,353,36,317
284623,W00001868,W00001868,Output Areas and Small Areas,OASA,207,25,182
284624,W00001869,W00001869,Output Areas and Small Areas,OASA,222,15,207
284625,W00001870,W00001870,Output Areas and Small Areas,OASA,252,19,233
284626,W00001871,W00001871,Output Areas and Small Areas,OASA,213,21,192
284627,W00001872,W00001872,Output Areas and Small Areas,OASA,214,16,198
284628,W00001874,W00001874,Output Areas and Small Areas,OASA,237,28,209
284629,W00001875,W00001875,Output Areas and Small Areas,OASA,269,24,245
284630,W00001876,W00001876,Output Areas and Small Areas,OASA,215,17,198
284631,W00001879,W00001879,Output Areas and Small Areas,OASA,133,10,123
284632,W00001880,W00001880,Output Areas and Small Areas,OASA,236,26,210
284633,W00001881,W00001881,Output Areas and Small Areas,OASA,210,16,194
284634,W00001882,W00001882,Output Areas and Small Areas,OASA,270,23,247
284635,W00001883,W00001883,Output Areas and Small Areas,OASA,216,27,189
284636,W00001884,W00001884,Output Areas and Small Areas,OASA,222,17,205
284637,W00001885,W00001885,Output Areas and Small Areas,OASA,268,9,259
284638,W00001886,W00001886,Output Areas and Small Areas,OASA,183,17,166
284639,W00001887,W00001887,Output Areas and Small Areas,OASA,207,23,184
284640,W00001888,W00001888,Output Areas and Small Areas,OASA,337,30,307
284641,W00001889,W00001889,Output Areas and Small Areas,OASA,248,24,224
284642,W00001890,W00001890,Output Areas and Small Areas,OASA,126,14,112
284643,W00001891,W00001891,Output Areas and Small Areas,OASA,167,7,160
284644,W00001892,W00001892,Output Areas and Small Areas,OASA,231,12,219
284645,W00001893,W00001893,Output Areas and Small Areas,OASA,329,36,293
284646,W00001894,W00001894,Output Areas and Small Areas,OASA,227,7,220
284647,W00001895,W00001895,Output Areas and Small Areas,OASA,325,17,308
284648,W00001896,W00001896,Output Areas and Small Areas,OASA,243,15,228
284649,W00001897,W00001897,Output Areas and Small Areas,OASA,219,8,211
284650,W00001898,W00001898,Output Areas and Small Areas,OASA,283,22,261
284651,W00001899,W00001899,Output Areas and Small Areas,OASA,201,12,189
284652,W00001900,W00001900,Output Areas and Small Areas,OASA,259,24,235
284653,W00001901,W00001901,Output Areas and Small Areas,OASA,264,34,230
284654,W00001902,W00001902,Output Areas and Small Areas,OASA,253,25,228
284655,W00001903,W00001903,Output Areas and Small Areas,OASA,256,20,236
284656,W00001904,W00001904,Output Areas and Small Areas,OASA,213,18,195
284657,W00001905,W00001905,Output Areas and Small Areas,OASA,259,16,243
284658,W00001906,W00001906,Output Areas and Small Areas,OASA,240,15,225
284659,W00001907,W00001907,Output Areas and Small Areas,OASA,300,18,282
284660,W00001908,W00001908,Output Areas and Small Areas,OASA,286,17,269
284661,W00001909,W00001909,Output Areas and Small Areas,OASA,416,34,382
284662,W00001910,W00001910,Output Areas and Small Areas,OASA,240,29,211
284663,W00001911,W00001911,Output Areas and Small Areas,OASA,282,28,254
284664,W00001912,W00001912,Output Areas and Small Areas,OASA,191,14,177
284665,W00001913,W00001913,Output Areas and Small Areas,OASA,239,22,217
284666,W00001914,W00001914,Output Areas and Small Areas,OASA,238,18,220
284667,W00001915,W00001915,Output Areas and Small Areas,OASA,246,101,145
284668,W00001916,W00001916,Output Areas and Small Areas,OASA,172,40,132
284669,W00001917,W00001917,Output Areas and Small Areas,OASA,262,39,223
284670,W00001918,W00001918,Output Areas and Small Areas,OASA,266,62,204
284671,W00001919,W00001919,Output Areas and Small Areas,OASA,282,74,208
284672,W00001920,W00001920,Output Areas and Small Areas,OASA,198,56,142
284673,W00001921,W00001921,Output Areas and Small Areas,OASA,178,70,108
284674,W00001922,W00001922,Output Areas and Small Areas,OASA,205,51,154
284675,W00001923,W00001923,Output Areas and Small Areas,OASA,272,22,250
284676,W00001924,W00001924,Output Areas and Small Areas,OASA,255,13,242
284677,W00001925,W00001925,Output Areas and Small Areas,OASA,220,18,202
284678,W00001926,W00001926,Output Areas and Small Areas,OASA,178,20,158
284679,W00001927,W00001927,Output Areas and Small Areas,OASA,208,12,196
284680,W00001928,W00001928,Output Areas and Small Areas,OASA,244,20,224
284681,W00001929,W00001929,Output Areas and Small Areas,OASA,308,29,279
284682,W00001930,W00001930,Output Areas and Small Areas,OASA,275,23,252
284683,W00001931,W00001931,Output Areas and Small Areas,OASA,295,37,258
284684,W00001932,W00001932,Output Areas and Small Areas,OASA,276,23,253
284685,W00001933,W00001933,Output Areas and Small Areas,OASA,268,25,243
284686,W00001934,W00001934,Output Areas and Small Areas,OASA,280,9,271
284687,W00001935,W00001935,Output Areas and Small Areas,OASA,347,31,316
284688,W00001936,W00001936,Output Areas and Small Areas,OASA,186,11,175
284689,W00001937,W00001937,Output Areas and Small Areas,OASA,275,43,232
284690,W00001938,W00001938,Output Areas and Small Areas,OASA,311,42,269
284691,W00001939,W00001939,Output Areas and Small Areas,OASA,281,46,235
284692,W00001940,W00001940,Output Areas and Small Areas,OASA,331,45,286
284693,W00001941,W00001941,Output Areas and Small Areas,OASA,248,29,219
284694,W00001942,W00001942,Output Areas and Small Areas,OASA,261,43,218
284695,W00001943,W00001943,Output Areas and Small Areas,OASA,236,46,190
284696,W00001944,W00001944,Output Areas and Small Areas,OASA,241,32,209
284697,W00001945,W00001945,Output Areas and Small Areas,OASA,277,33,244
284698,W00001946,W00001946,Output Areas and Small Areas,OASA,202,36,166
284699,W00001947,W00001947,Output Areas and Small Areas,OASA,210,47,163
284700,W00001948,W00001948,Output Areas and Small Areas,OASA,253,20,233
284701,W00001949,W00001949,Output Areas and Small Areas,OASA,241,33,208
284702,W00001950,W00001950,Output Areas and Small Areas,OASA,250,30,220
284703,W00001951,W00001951,Output Areas and Small Areas,OASA,178,22,156
284704,W00001952,W00001952,Output Areas and Small Areas,OASA,343,50,293
284705,W00001953,W00001953,Output Areas and Small Areas,OASA,378,26,352
284706,W00001954,W00001954,Output Areas and Small Areas,OASA,274,28,246
284707,W00001955,W00001955,Output Areas and Small Areas,OASA,378,43,335
284708,W00001956,W00001956,Output Areas and Small Areas,OASA,251,58,193
284709,W00001957,W00001957,Output Areas and Small Areas,OASA,272,23,249
284710,W00001958,W00001958,Output Areas and Small Areas,OASA,219,9,210
284711,W00001959,W00001959,Output Areas and Small Areas,OASA,116,14,102
284712,W00001960,W00001960,Output Areas and Small Areas,OASA,215,17,198
284713,W00001961,W00001961,Output Areas and Small Areas,OASA,162,15,147
284714,W00001962,W00001962,Output Areas and Small Areas,OASA,261,16,245
284715,W00001963,W00001963,Output Areas and Small Areas,OASA,312,30,282
284716,W00001964,W00001964,Output Areas and Small Areas,OASA,240,29,211
284717,W00001965,W00001965,Output Areas and Small Areas,OASA,230,14,216
284718,W00001966,W00001966,Output Areas and Small Areas,OASA,208,15,193
284719,W00001967,W00001967,Output Areas and Small Areas,OASA,240,15,225
284720,W00001968,W00001968,Output Areas and Small Areas,OASA,228,30,198
284721,W00001969,W00001969,Output Areas and Small Areas,OASA,239,26,213
284722,W00001970,W00001970,Output Areas and Small Areas,OASA,239,33,206
284723,W00001971,W00001971,Output Areas and Small Areas,OASA,269,37,232
284724,W00001972,W00001972,Output Areas and Small Areas,OASA,208,16,192
284725,W00001973,W00001973,Output Areas and Small Areas,OASA,256,27,229
284726,W00001974,W00001974,Output Areas and Small Areas,OASA,269,22,247
284727,W00001975,W00001975,Output Areas and Small Areas,OASA,217,19,198
284728,W00001976,W00001976,Output Areas and Small Areas,OASA,210,17,193
284729,W00001977,W00001977,Output Areas and Small Areas,OASA,229,18,211
284730,W00001978,W00001978,Output Areas and Small Areas,OASA,240,20,220
284731,W00001979,W00001979,Output Areas and Small Areas,OASA,197,17,180
284732,W00001980,W00001980,Output Areas and Small Areas,OASA,284,21,263
284733,W00001981,W00001981,Output Areas and Small Areas,OASA,213,11,202
284734,W00001982,W00001982,Output Areas and Small Areas,OASA,255,21,234
284735,W00001983,W00001983,Output Areas and Small Areas,OASA,196,8,188
284736,W00001984,W00001984,Output Areas and Small Areas,OASA,272,21,251
284737,W00001985,W00001985,Output Areas and Small Areas,OASA,266,16,250
284738,W00001986,W00001986,Output Areas and Small Areas,OASA,363,35,328
284739,W00001987,W00001987,Output Areas and Small Areas,OASA,212,7,205
284740,W00001988,W00001988,Output Areas and Small Areas,OASA,246,22,224
284741,W00001989,W00001989,Output Areas and Small Areas,OASA,256,24,232
284742,W00001990,W00001990,Output Areas and Small Areas,OASA,440,44,396
284743,W00001991,W00001991,Output Areas and Small Areas,OASA,320,25,295
284744,W00001992,W00001992,Output Areas and Small Areas,OASA,235,30,205
284745,W00001993,W00001993,Output Areas and Small Areas,OASA,243,19,224
284746,W00001994,W00001994,Output Areas and Small Areas,OASA,214,8,206
284747,W00001995,W00001995,Output Areas and Small Areas,OASA,211,16,195
284748,W00001996,W00001996,Output Areas and Small Areas,OASA,223,14,209
284749,W00001997,W00001997,Output Areas and Small Areas,OASA,250,18,232
284750,W00001998,W00001998,Output Areas and Small Areas,OASA,268,27,241
284751,W00001999,W00001999,Output Areas and Small Areas,OASA,249,11,238
284752,W00002000,W00002000,Output Areas and Small Areas,OASA,209,11,198
284753,W00002001,W00002001,Output Areas and Small Areas,OASA,323,35,288
284754,W00002002,W00002002,Output Areas and Small Areas,OASA,216,12,204
284755,W00002003,W00002003,Output Areas and Small Areas,OASA,215,7,208
284756,W00002004,W00002004,Output Areas and Small Areas,OASA,202,18,184
284757,W00002005,W00002005,Output Areas and Small Areas,OASA,216,13,203
284758,W00002006,W00002006,Output Areas and Small Areas,OASA,256,18,238
284759,W00002007,W00002007,Output Areas and Small Areas,OASA,224,13,211
284760,W00002008,W00002008,Output Areas and Small Areas,OASA,245,34,211
284761,W00002009,W00002009,Output Areas and Small Areas,OASA,219,12,207
284762,W00002010,W00002010,Output Areas and Small Areas,OASA,267,16,251
284763,W00002011,W00002011,Output Areas and Small Areas,OASA,453,39,414
284764,W00002014,W00002014,Output Areas and Small Areas,OASA,317,26,291
284765,W00002016,W00002016,Output Areas and Small Areas,OASA,274,20,254
284766,W00002017,W00002017,Output Areas and Small Areas,OASA,169,8,161
284767,W00002018,W00002018,Output Areas and Small Areas,OASA,207,13,194
284768,W00002019,W00002019,Output Areas and Small Areas,OASA,375,24,351
284769,W00002020,W00002020,Output Areas and Small Areas,OASA,284,33,251
284770,W00002021,W00002021,Output Areas and Small Areas,OASA,224,12,212
284771,W00002022,W00002022,Output Areas and Small Areas,OASA,504,49,455
284772,W00002023,W00002023,Output Areas and Small Areas,OASA,236,11,225
284773,W00002024,W00002024,Output Areas and Small Areas,OASA,232,30,202
284774,W00002025,W00002025,Output Areas and Small Areas,OASA,215,17,198
284775,W00002026,W00002026,Output Areas and Small Areas,OASA,238,16,222
284776,W00002027,W00002027,Output Areas and Small Areas,OASA,186,15,171
284777,W00002028,W00002028,Output Areas and Small Areas,OASA,257,21,236
284778,W00002029,W00002029,Output Areas and Small Areas,OASA,261,27,234
284779,W00002030,W00002030,Output Areas and Small Areas,OASA,212,17,195
284780,W00002031,W00002031,Output Areas and Small Areas,OASA,184,14,170
284781,W00002032,W00002032,Output Areas and Small Areas,OASA,286,17,269
284782,W00002033,W00002033,Output Areas and Small Areas,OASA,225,25,200
284783,W00002034,W00002034,Output Areas and Small Areas,OASA,272,36,236
284784,W00002035,W00002035,Output Areas and Small Areas,OASA,221,29,192
284785,W00002036,W00002036,Output Areas and Small Areas,OASA,146,14,132
284786,W00002037,W00002037,Output Areas and Small Areas,OASA,178,14,164
284787,W00002038,W00002038,Output Areas and Small Areas,OASA,93,8,85
284788,W00002039,W00002039,Output Areas and Small Areas,OASA,120,10,110
284789,W00002040,W00002040,Output Areas and Small Areas,OASA,302,29,273
284790,W00002041,W00002041,Output Areas and Small Areas,OASA,324,27,297
284791,W00002042,W00002042,Output Areas and Small Areas,OASA,233,9,224
284792,W00002043,W00002043,Output Areas and Small Areas,OASA,241,12,229
284793,W00002044,W00002044,Output Areas and Small Areas,OASA,226,20,206
284794,W00002045,W00002045,Output Areas and Small Areas,OASA,210,16,194
284795,W00002046,W00002046,Output Areas and Small Areas,OASA,263,13,250
284796,W00002047,W00002047,Output Areas and Small Areas,OASA,344,15,329
284797,W00002049,W00002049,Output Areas and Small Areas,OASA,311,18,293
284798,W00002050,W00002050,Output Areas and Small Areas,OASA,245,53,192
284799,W00002051,W00002051,Output Areas and Small Areas,OASA,239,40,199
284800,W00002052,W00002052,Output Areas and Small Areas,OASA,249,36,213
284801,W00002053,W00002053,Output Areas and Small Areas,OASA,173,32,141
284802,W00002054,W00002054,Output Areas and Small Areas,OASA,225,39,186
284803,W00002055,W00002055,Output Areas and Small Areas,OASA,234,34,200
284804,W00002056,W00002056,Output Areas and Small Areas,OASA,290,36,254
284805,W00002057,W00002057,Output Areas and Small Areas,OASA,262,25,237
284806,W00002058,W00002058,Output Areas and Small Areas,OASA,232,19,213
284807,W00002059,W00002059,Output Areas and Small Areas,OASA,258,41,217
284808,W00002060,W00002060,Output Areas and Small Areas,OASA,242,37,205
284809,W00002061,W00002061,Output Areas and Small Areas,OASA,209,18,191
284810,W00002062,W00002062,Output Areas and Small Areas,OASA,218,22,196
284811,W00002063,W00002063,Output Areas and Small Areas,OASA,237,26,211
284812,W00002064,W00002064,Output Areas and Small Areas,OASA,242,32,210
284813,W00002065,W00002065,Output Areas and Small Areas,OASA,226,30,196
284814,W00002066,W00002066,Output Areas and Small Areas,OASA,286,43,243
284815,W00002067,W00002067,Output Areas and Small Areas,OASA,253,26,227
284816,W00002068,W00002068,Output Areas and Small Areas,OASA,266,27,239
284817,W00002069,W00002069,Output Areas and Small Areas,OASA,260,25,235
284818,W00002070,W00002070,Output Areas and Small Areas,OASA,247,27,220
284819,W00002071,W00002071,Output Areas and Small Areas,OASA,190,15,175
284820,W00002072,W00002072,Output Areas and Small Areas,OASA,244,25,219
284821,W00002073,W00002073,Output Areas and Small Areas,OASA,242,24,218
284822,W00002074,W00002074,Output Areas and Small Areas,OASA,253,36,217
284823,W00002075,W00002075,Output Areas and Small Areas,OASA,224,42,182
284824,W00002076,W00002076,Output Areas and Small Areas,OASA,260,21,239
284825,W00002077,W00002077,Output Areas and Small Areas,OASA,213,15,198
284826,W00002078,W00002078,Output Areas and Small Areas,OASA,217,15,202
284827,W00002079,W00002079,Output Areas and Small Areas,OASA,282,20,262
284828,W00002080,W00002080,Output Areas and Small Areas,OASA,212,14,198
284829,W00002081,W00002081,Output Areas and Small Areas,OASA,224,11,213
284830,W00002082,W00002082,Output Areas and Small Areas,OASA,211,21,190
284831,W00002083,W00002083,Output Areas and Small Areas,OASA,237,27,210
284832,W00002084,W00002084,Output Areas and Small Areas,OASA,210,14,196
284833,W00002085,W00002085,Output Areas and Small Areas,OASA,230,25,205
284834,W00002086,W00002086,Output Areas and Small Areas,OASA,114,11,103
284835,W00002087,W00002087,Output Areas and Small Areas,OASA,428,28,400
284836,W00002088,W00002088,Output Areas and Small Areas,OASA,138,9,129
284837,W00002089,W00002089,Output Areas and Small Areas,OASA,215,11,204
284838,W00002090,W00002090,Output Areas and Small Areas,OASA,261,20,241
284839,W00002091,W00002091,Output Areas and Small Areas,OASA,242,17,225
284840,W00002092,W00002092,Output Areas and Small Areas,OASA,208,15,193
284841,W00002093,W00002093,Output Areas and Small Areas,OASA,210,18,192
284842,W00002094,W00002094,Output Areas and Small Areas,OASA,212,22,190
284843,W00002095,W00002095,Output Areas and Small Areas,OASA,250,13,237
284844,W00002096,W00002096,Output Areas and Small Areas,OASA,226,37,189
284845,W00002097,W00002097,Output Areas and Small Areas,OASA,209,7,202
284846,W00002098,W00002098,Output Areas and Small Areas,OASA,269,32,237
284847,W00002099,W00002099,Output Areas and Small Areas,OASA,236,27,209
284848,W00002100,W00002100,Output Areas and Small Areas,OASA,332,17,315
284849,W00002101,W00002101,Output Areas and Small Areas,OASA,226,12,214
284850,W00002102,W00002102,Output Areas and Small Areas,OASA,220,18,202
284851,W00002103,W00002103,Output Areas and Small Areas,OASA,225,32,193
284852,W00002104,W00002104,Output Areas and Small Areas,OASA,218,9,209
284853,W00002105,W00002105,Output Areas and Small Areas,OASA,238,16,222
284854,W00002106,W00002106,Output Areas and Small Areas,OASA,275,27,248
284855,W00002107,W00002107,Output Areas and Small Areas,OASA,223,16,207
284856,W00002108,W00002108,Output Areas and Small Areas,OASA,267,19,248
284857,W00002109,W00002109,Output Areas and Small Areas,OASA,307,33,274
284858,W00002110,W00002110,Output Areas and Small Areas,OASA,248,26,222
284859,W00002111,W00002111,Output Areas and Small Areas,OASA,279,19,260
284860,W00002112,W00002112,Output Areas and Small Areas,OASA,247,7,240
284861,W00002113,W00002113,Output Areas and Small Areas,OASA,240,17,223
284862,W00002114,W00002114,Output Areas and Small Areas,OASA,287,21,266
284863,W00002115,W00002115,Output Areas and Small Areas,OASA,504,70,434
284864,W00002116,W00002116,Output Areas and Small Areas,OASA,104,19,85
284865,W00002117,W00002117,Output Areas and Small Areas,OASA,95,9,86
284866,W00002118,W00002118,Output Areas and Small Areas,OASA,250,46,204
284867,W00002119,W00002119,Output Areas and Small Areas,OASA,270,41,229
284868,W00002120,W00002120,Output Areas and Small Areas,OASA,310,41,269
284869,W00002121,W00002121,Output Areas and Small Areas,OASA,278,43,235
284870,W00002122,W00002122,Output Areas and Small Areas,OASA,230,33,197
284871,W00002123,W00002123,Output Areas and Small Areas,OASA,280,15,265
284872,W00002124,W00002124,Output Areas and Small Areas,OASA,228,19,209
284873,W00002125,W00002125,Output Areas and Small Areas,OASA,285,21,264
284874,W00002126,W00002126,Output Areas and Small Areas,OASA,256,21,235
284875,W00002127,W00002127,Output Areas and Small Areas,OASA,222,19,203
284876,W00002128,W00002128,Output Areas and Small Areas,OASA,193,14,179
284877,W00002129,W00002129,Output Areas and Small Areas,OASA,219,21,198
284878,W00002130,W00002130,Output Areas and Small Areas,OASA,374,25,349
284879,W00002131,W00002131,Output Areas and Small Areas,OASA,263,21,242
284880,W00002132,W00002132,Output Areas and Small Areas,OASA,224,24,200
284881,W00002133,W00002133,Output Areas and Small Areas,OASA,197,9,188
284882,W00002134,W00002134,Output Areas and Small Areas,OASA,272,18,254
284883,W00002135,W00002135,Output Areas and Small Areas,OASA,219,20,199
284884,W00002136,W00002136,Output Areas and Small Areas,OASA,302,23,279
284885,W00002137,W00002137,Output Areas and Small Areas,OASA,255,19,236
284886,W00002138,W00002138,Output Areas and Small Areas,OASA,303,41,262
284887,W00002139,W00002139,Output Areas and Small Areas,OASA,356,27,329
284888,W00002140,W00002140,Output Areas and Small Areas,OASA,273,26,247
284889,W00002141,W00002141,Output Areas and Small Areas,OASA,277,6,271
284890,W00002142,W00002142,Output Areas and Small Areas,OASA,295,13,282
284891,W00002143,W00002143,Output Areas and Small Areas,OASA,254,12,242
284892,W00002144,W00002144,Output Areas and Small Areas,OASA,241,13,228
284893,W00002145,W00002145,Output Areas and Small Areas,OASA,316,9,307
284894,W00002146,W00002146,Output Areas and Small Areas,OASA,144,2,142
284895,W00002147,W00002147,Output Areas and Small Areas,OASA,334,28,306
284896,W00002148,W00002148,Output Areas and Small Areas,OASA,185,10,175
284897,W00002149,W00002149,Output Areas and Small Areas,OASA,206,12,194
284898,W00002150,W00002150,Output Areas and Small Areas,OASA,224,15,209
284899,W00002151,W00002151,Output Areas and Small Areas,OASA,340,18,322
284900,W00002152,W00002152,Output Areas and Small Areas,OASA,158,10,148
284901,W00002153,W00002153,Output Areas and Small Areas,OASA,213,37,176
284902,W00002154,W00002154,Output Areas and Small Areas,OASA,281,65,216
284903,W00002155,W00002155,Output Areas and Small Areas,OASA,311,65,246
284904,W00002156,W00002156,Output Areas and Small Areas,OASA,244,34,210
284905,W00002157,W00002157,Output Areas and Small Areas,OASA,231,55,176
284906,W00002158,W00002158,Output Areas and Small Areas,OASA,243,69,174
284907,W00002159,W00002159,Output Areas and Small Areas,OASA,236,103,133
284908,W00002160,W00002160,Output Areas and Small Areas,OASA,217,23,194
284909,W00002161,W00002161,Output Areas and Small Areas,OASA,222,35,187
284910,W00002162,W00002162,Output Areas and Small Areas,OASA,245,46,199
284911,W00002163,W00002163,Output Areas and Small Areas,OASA,239,43,196
284912,W00002164,W00002164,Output Areas and Small Areas,OASA,255,54,201
284913,W00002165,W00002165,Output Areas and Small Areas,OASA,276,41,235
284914,W00002166,W00002166,Output Areas and Small Areas,OASA,219,37,182
284915,W00002167,W00002167,Output Areas and Small Areas,OASA,210,41,169
284916,W00002168,W00002168,Output Areas and Small Areas,OASA,259,29,230
284917,W00002169,W00002169,Output Areas and Small Areas,OASA,246,43,203
284918,W00002170,W00002170,Output Areas and Small Areas,OASA,223,38,185
284919,W00002171,W00002171,Output Areas and Small Areas,OASA,231,39,192
284920,W00002172,W00002172,Output Areas and Small Areas,OASA,251,27,224
284921,W00002173,W00002173,Output Areas and Small Areas,OASA,314,23,291
284922,W00002174,W00002174,Output Areas and Small Areas,OASA,325,38,287
284923,W00002175,W00002175,Output Areas and Small Areas,OASA,249,17,232
284924,W00002176,W00002176,Output Areas and Small Areas,OASA,239,20,219
284925,W00002177,W00002177,Output Areas and Small Areas,OASA,213,16,197
284926,W00002178,W00002178,Output Areas and Small Areas,OASA,242,22,220
284927,W00002179,W00002179,Output Areas and Small Areas,OASA,218,22,196
284928,W00002180,W00002180,Output Areas and Small Areas,OASA,235,11,224
284929,W00002181,W00002181,Output Areas and Small Areas,OASA,275,50,225
284930,W00002182,W00002182,Output Areas and Small Areas,OASA,347,75,272
284931,W00002183,W00002183,Output Areas and Small Areas,OASA,221,56,165
284932,W00002184,W00002184,Output Areas and Small Areas,OASA,229,57,172
284933,W00002185,W00002185,Output Areas and Small Areas,OASA,269,91,178
284934,W00002186,W00002186,Output Areas and Small Areas,OASA,246,70,176
284935,W00002187,W00002187,Output Areas and Small Areas,OASA,243,56,187
284936,W00002188,W00002188,Output Areas and Small Areas,OASA,222,54,168
284937,W00002189,W00002189,Output Areas and Small Areas,OASA,251,82,169
284938,W00002190,W00002190,Output Areas and Small Areas,OASA,276,84,192
284939,W00002191,W00002191,Output Areas and Small Areas,OASA,250,77,173
284940,W00002192,W00002192,Output Areas and Small Areas,OASA,182,56,126
284941,W00002193,W00002193,Output Areas and Small Areas,OASA,203,45,158
284942,W00002194,W00002194,Output Areas and Small Areas,OASA,212,56,156
284943,W00002195,W00002195,Output Areas and Small Areas,OASA,264,83,181
284944,W00002196,W00002196,Output Areas and Small Areas,OASA,257,47,210
284945,W00002197,W00002197,Output Areas and Small Areas,OASA,260,6,254
284946,W00002198,W00002198,Output Areas and Small Areas,OASA,211,16,195
284947,W00002199,W00002199,Output Areas and Small Areas,OASA,193,7,186
284948,W00002200,W00002200,Output Areas and Small Areas,OASA,189,7,182
284949,W00002201,W00002201,Output Areas and Small Areas,OASA,260,18,242
284950,W00002202,W00002202,Output Areas and Small Areas,OASA,241,6,235
284951,W00002203,W00002203,Output Areas and Small Areas,OASA,251,6,245
284952,W00002204,W00002204,Output Areas and Small Areas,OASA,221,9,212
284953,W00002205,W00002205,Output Areas and Small Areas,OASA,359,23,336
284954,W00002206,W00002206,Output Areas and Small Areas,OASA,245,21,224
284955,W00002207,W00002207,Output Areas and Small Areas,OASA,206,11,195
284956,W00002208,W00002208,Output Areas and Small Areas,OASA,194,13,181
284957,W00002209,W00002209,Output Areas and Small Areas,OASA,228,20,208
284958,W00002210,W00002210,Output Areas and Small Areas,OASA,224,13,211
284959,W00002211,W00002211,Output Areas and Small Areas,OASA,254,18,236
284960,W00002212,W00002212,Output Areas and Small Areas,OASA,249,22,227
284961,W00002213,W00002213,Output Areas and Small Areas,OASA,187,20,167
284962,W00002214,W00002214,Output Areas and Small Areas,OASA,178,14,164
284963,W00002215,W00002215,Output Areas and Small Areas,OASA,295,23,272
284964,W00002216,W00002216,Output Areas and Small Areas,OASA,241,16,225
284965,W00002217,W00002217,Output Areas and Small Areas,OASA,233,15,218
284966,W00002218,W00002218,Output Areas and Small Areas,OASA,233,8,225
284967,W00002219,W00002219,Output Areas and Small Areas,OASA,203,11,192
284968,W00002220,W00002220,Output Areas and Small Areas,OASA,238,25,213
284969,W00002221,W00002221,Output Areas and Small Areas,OASA,196,8,188
284970,W00002222,W00002222,Output Areas and Small Areas,OASA,225,20,205
284971,W00002223,W00002223,Output Areas and Small Areas,OASA,225,13,212
284972,W00002224,W00002224,Output Areas and Small Areas,OASA,246,15,231
284973,W00002225,W00002225,Output Areas and Small Areas,OASA,320,12,308
284974,W00002226,W00002226,Output Areas and Small Areas,OASA,208,29,179
284975,W00002227,W00002227,Output Areas and Small Areas,OASA,127,17,110
284976,W00002228,W00002228,Output Areas and Small Areas,OASA,300,31,269
284977,W00002229,W00002229,Output Areas and Small Areas,OASA,186,15,171
284978,W00002231,W00002231,Output Areas and Small Areas,OASA,179,16,163
284979,W00002232,W00002232,Output Areas and Small Areas,OASA,211,18,193
284980,W00002233,W00002233,Output Areas and Small Areas,OASA,230,20,210
284981,W00002234,W00002234,Output Areas and Small Areas,OASA,230,13,217
284982,W00002235,W00002235,Output Areas and Small Areas,OASA,176,19,157
284983,W00002236,W00002236,Output Areas and Small Areas,OASA,304,9,295
284984,W00002237,W00002237,Output Areas and Small Areas,OASA,291,16,275
284985,W00002238,W00002238,Output Areas and Small Areas,OASA,371,15,356
284986,W00002239,W00002239,Output Areas and Small Areas,OASA,182,9,173
284987,W00002240,W00002240,Output Areas and Small Areas,OASA,317,19,298
284988,W00002241,W00002241,Output Areas and Small Areas,OASA,306,17,289
284989,W00002242,W00002242,Output Areas and Small Areas,OASA,255,31,224
284990,W00002243,W00002243,Output Areas and Small Areas,OASA,279,24,255
284991,W00002244,W00002244,Output Areas and Small Areas,OASA,253,18,235
284992,W00002245,W00002245,Output Areas and Small Areas,OASA,201,25,176
284993,W00002246,W00002246,Output Areas and Small Areas,OASA,231,11,220
284994,W00002247,W00002247,Output Areas and Small Areas,OASA,209,16,193
284995,W00002248,W00002248,Output Areas and Small Areas,OASA,234,28,206
284996,W00002249,W00002249,Output Areas and Small Areas,OASA,257,20,237
284997,W00002250,W00002250,Output Areas and Small Areas,OASA,224,19,205
284998,W00002251,W00002251,Output Areas and Small Areas,OASA,196,17,179
284999,W00002253,W00002253,Output Areas and Small Areas,OASA,267,25,242
285000,W00002254,W00002254,Output Areas and Small Areas,OASA,240,20,220
285001,W00002255,W00002255,Output Areas and Small Areas,OASA,322,30,292
285002,W00002256,W00002256,Output Areas and Small Areas,OASA,268,20,248
285003,W00002257,W00002257,Output Areas and Small Areas,OASA,291,19,272
285004,W00002258,W00002258,Output Areas and Small Areas,OASA,240,8,232
285005,W00002259,W00002259,Output Areas and Small Areas,OASA,269,27,242
285006,W00002260,W00002260,Output Areas and Small Areas,OASA,262,29,233
285007,W00002261,W00002261,Output Areas and Small Areas,OASA,263,13,250
285008,W00002262,W00002262,Output Areas and Small Areas,OASA,225,15,210
285009,W00002263,W00002263,Output Areas and Small Areas,OASA,256,13,243
285010,W00002264,W00002264,Output Areas and Small Areas,OASA,242,8,234
285011,W00002265,W00002265,Output Areas and Small Areas,OASA,259,17,242
285012,W00002266,W00002266,Output Areas and Small Areas,OASA,214,10,204
285013,W00002267,W00002267,Output Areas and Small Areas,OASA,220,9,211
285014,W00002268,W00002268,Output Areas and Small Areas,OASA,279,103,176
285015,W00002269,W00002269,Output Areas and Small Areas,OASA,276,97,179
285016,W00002270,W00002270,Output Areas and Small Areas,OASA,125,47,78
285017,W00002271,W00002271,Output Areas and Small Areas,OASA,228,103,125
285018,W00002272,W00002272,Output Areas and Small Areas,OASA,289,104,185
285019,W00002273,W00002273,Output Areas and Small Areas,OASA,237,134,103
285020,W00002274,W00002274,Output Areas and Small Areas,OASA,274,128,146
285021,W00002275,W00002275,Output Areas and Small Areas,OASA,319,153,166
285022,W00002276,W00002276,Output Areas and Small Areas,OASA,287,11,276
285023,W00002277,W00002277,Output Areas and Small Areas,OASA,306,22,284
285024,W00002278,W00002278,Output Areas and Small Areas,OASA,258,17,241
285025,W00002279,W00002279,Output Areas and Small Areas,OASA,320,23,297
285026,W00002280,W00002280,Output Areas and Small Areas,OASA,253,19,234
285027,W00002281,W00002281,Output Areas and Small Areas,OASA,307,16,291
285028,W00002282,W00002282,Output Areas and Small Areas,OASA,295,28,267
285029,W00002283,W00002283,Output Areas and Small Areas,OASA,286,20,266
285030,W00002284,W00002284,Output Areas and Small Areas,OASA,295,55,240
285031,W00002285,W00002285,Output Areas and Small Areas,OASA,327,50,277
285032,W00002286,W00002286,Output Areas and Small Areas,OASA,263,57,206
285033,W00002287,W00002287,Output Areas and Small Areas,OASA,273,44,229
285034,W00002288,W00002288,Output Areas and Small Areas,OASA,241,50,191
285035,W00002289,W00002289,Output Areas and Small Areas,OASA,298,60,238
285036,W00002290,W00002290,Output Areas and Small Areas,OASA,217,74,143
285037,W00002291,W00002291,Output Areas and Small Areas,OASA,242,18,224
285038,W00002292,W00002292,Output Areas and Small Areas,OASA,276,12,264
285039,W00002293,W00002293,Output Areas and Small Areas,OASA,195,14,181
285040,W00002294,W00002294,Output Areas and Small Areas,OASA,357,18,339
285041,W00002295,W00002295,Output Areas and Small Areas,OASA,249,24,225
285042,W00002296,W00002296,Output Areas and Small Areas,OASA,206,18,188
285043,W00002297,W00002297,Output Areas and Small Areas,OASA,247,23,224
285044,W00002298,W00002298,Output Areas and Small Areas,OASA,255,24,231
285045,W00002299,W00002299,Output Areas and Small Areas,OASA,238,25,213
285046,W00002300,W00002300,Output Areas and Small Areas,OASA,292,30,262
285047,W00002301,W00002301,Output Areas and Small Areas,OASA,269,23,246
285048,W00002302,W00002302,Output Areas and Small Areas,OASA,308,38,270
285049,W00002303,W00002303,Output Areas and Small Areas,OASA,273,23,250
285050,W00002305,W00002305,Output Areas and Small Areas,OASA,263,12,251
285051,W00002306,W00002306,Output Areas and Small Areas,OASA,182,36,146
285052,W00002307,W00002307,Output Areas and Small Areas,OASA,207,36,171
285053,W00002308,W00002308,Output Areas and Small Areas,OASA,329,68,261
285054,W00002309,W00002309,Output Areas and Small Areas,OASA,305,53,252
285055,W00002310,W00002310,Output Areas and Small Areas,OASA,309,45,264
285056,W00002311,W00002311,Output Areas and Small Areas,OASA,319,99,220
285057,W00002312,W00002312,Output Areas and Small Areas,OASA,308,107,201
285058,W00002313,W00002313,Output Areas and Small Areas,OASA,265,5,260
285059,W00002314,W00002314,Output Areas and Small Areas,OASA,285,2,283
285060,W00002315,W00002315,Output Areas and Small Areas,OASA,301,15,286
285061,W00002316,W00002316,Output Areas and Small Areas,OASA,260,8,252
285062,W00002317,W00002317,Output Areas and Small Areas,OASA,295,6,289
285063,W00002320,W00002320,Output Areas and Small Areas,OASA,228,10,218
285064,W00002321,W00002321,Output Areas and Small Areas,OASA,297,27,270
285065,W00002323,W00002323,Output Areas and Small Areas,OASA,259,15,244
285066,W00002324,W00002324,Output Areas and Small Areas,OASA,205,9,196
285067,W00002325,W00002325,Output Areas and Small Areas,OASA,382,19,363
285068,W00002327,W00002327,Output Areas and Small Areas,OASA,219,63,156
285069,W00002328,W00002328,Output Areas and Small Areas,OASA,311,142,169
285070,W00002329,W00002329,Output Areas and Small Areas,OASA,244,92,152
285071,W00002330,W00002330,Output Areas and Small Areas,OASA,123,50,73
285072,W00002331,W00002331,Output Areas and Small Areas,OASA,177,104,73
285073,W00002332,W00002332,Output Areas and Small Areas,OASA,192,90,102
285074,W00002333,W00002333,Output Areas and Small Areas,OASA,132,58,74
285075,W00002335,W00002335,Output Areas and Small Areas,OASA,329,15,314
285076,W00002336,W00002336,Output Areas and Small Areas,OASA,290,24,266
285077,W00002337,W00002337,Output Areas and Small Areas,OASA,296,28,268
285078,W00002338,W00002338,Output Areas and Small Areas,OASA,175,15,160
285079,W00002339,W00002339,Output Areas and Small Areas,OASA,359,45,314
285080,W00002340,W00002340,Output Areas and Small Areas,OASA,363,30,333
285081,W00002341,W00002341,Output Areas and Small Areas,OASA,247,17,230
285082,W00002342,W00002342,Output Areas and Small Areas,OASA,274,26,248
285083,W00002343,W00002343,Output Areas and Small Areas,OASA,368,31,337
285084,W00002344,W00002344,Output Areas and Small Areas,OASA,279,16,263
285085,W00002345,W00002345,Output Areas and Small Areas,OASA,288,22,266
285086,W00002346,W00002346,Output Areas and Small Areas,OASA,364,32,332
285087,W00002347,W00002347,Output Areas and Small Areas,OASA,190,25,165
285088,W00002348,W00002348,Output Areas and Small Areas,OASA,273,23,250
285089,W00002349,W00002349,Output Areas and Small Areas,OASA,308,20,288
285090,W00002350,W00002350,Output Areas and Small Areas,OASA,288,11,277
285091,W00002351,W00002351,Output Areas and Small Areas,OASA,283,24,259
285092,W00002352,W00002352,Output Areas and Small Areas,OASA,256,176,80
285093,W00002353,W00002353,Output Areas and Small Areas,OASA,201,107,94
285094,W00002354,W00002354,Output Areas and Small Areas,OASA,257,144,113
285095,W00002355,W00002355,Output Areas and Small Areas,OASA,240,126,114
285096,W00002356,W00002356,Output Areas and Small Areas,OASA,252,127,125
285097,W00002357,W00002357,Output Areas and Small Areas,OASA,244,127,117
285098,W00002358,W00002358,Output Areas and Small Areas,OASA,249,110,139
285099,W00002359,W00002359,Output Areas and Small Areas,OASA,316,15,301
285100,W00002360,W00002360,Output Areas and Small Areas,OASA,344,19,325
285101,W00002361,W00002361,Output Areas and Small Areas,OASA,323,20,303
285102,W00002362,W00002362,Output Areas and Small Areas,OASA,274,16,258
285103,W00002363,W00002363,Output Areas and Small Areas,OASA,242,15,227
285104,W00002364,W00002364,Output Areas and Small Areas,OASA,439,20,419
285105,W00002365,W00002365,Output Areas and Small Areas,OASA,271,29,242
285106,W00002366,W00002366,Output Areas and Small Areas,OASA,206,21,185
285107,W00002367,W00002367,Output Areas and Small Areas,OASA,279,35,244
285108,W00002368,W00002368,Output Areas and Small Areas,OASA,296,37,259
285109,W00002369,W00002369,Output Areas and Small Areas,OASA,216,24,192
285110,W00002370,W00002370,Output Areas and Small Areas,OASA,190,26,164
285111,W00002371,W00002371,Output Areas and Small Areas,OASA,258,30,228
285112,W00002372,W00002372,Output Areas and Small Areas,OASA,203,17,186
285113,W00002373,W00002373,Output Areas and Small Areas,OASA,290,18,272
285114,W00002374,W00002374,Output Areas and Small Areas,OASA,327,20,307
285115,W00002375,W00002375,Output Areas and Small Areas,OASA,246,10,236
285116,W00002376,W00002376,Output Areas and Small Areas,OASA,195,5,190
285117,W00002377,W00002377,Output Areas and Small Areas,OASA,218,17,201
285118,W00002378,W00002378,Output Areas and Small Areas,OASA,184,8,176
285119,W00002379,W00002379,Output Areas and Small Areas,OASA,228,14,214
285120,W00002380,W00002380,Output Areas and Small Areas,OASA,218,9,209
285121,W00002381,W00002381,Output Areas and Small Areas,OASA,213,17,196
285122,W00002382,W00002382,Output Areas and Small Areas,OASA,242,10,232
285123,W00002383,W00002383,Output Areas and Small Areas,OASA,274,10,264
285124,W00002384,W00002384,Output Areas and Small Areas,OASA,346,22,324
285125,W00002385,W00002385,Output Areas and Small Areas,OASA,253,29,224
285126,W00002386,W00002386,Output Areas and Small Areas,OASA,326,25,301
285127,W00002387,W00002387,Output Areas and Small Areas,OASA,386,26,360
285128,W00002388,W00002388,Output Areas and Small Areas,OASA,137,9,128
285129,W00002389,W00002389,Output Areas and Small Areas,OASA,240,13,227
285130,W00002390,W00002390,Output Areas and Small Areas,OASA,241,10,231
285131,W00002391,W00002391,Output Areas and Small Areas,OASA,199,10,189
285132,W00002392,W00002392,Output Areas and Small Areas,OASA,235,5,230
285133,W00002393,W00002393,Output Areas and Small Areas,OASA,269,9,260
285134,W00002394,W00002394,Output Areas and Small Areas,OASA,173,9,164
285135,W00002395,W00002395,Output Areas and Small Areas,OASA,174,11,163
285136,W00002396,W00002396,Output Areas and Small Areas,OASA,192,6,186
285137,W00002397,W00002397,Output Areas and Small Areas,OASA,244,8,236
285138,W00002398,W00002398,Output Areas and Small Areas,OASA,329,21,308
285139,W00002399,W00002399,Output Areas and Small Areas,OASA,268,9,259
285140,W00002400,W00002400,Output Areas and Small Areas,OASA,186,10,176
285141,W00002401,W00002401,Output Areas and Small Areas,OASA,120,7,113
285142,W00002402,W00002402,Output Areas and Small Areas,OASA,251,17,234
285143,W00002403,W00002403,Output Areas and Small Areas,OASA,240,21,219
285144,W00002404,W00002404,Output Areas and Small Areas,OASA,394,31,363
285145,W00002405,W00002405,Output Areas and Small Areas,OASA,157,21,136
285146,W00002406,W00002406,Output Areas and Small Areas,OASA,315,24,291
285147,W00002407,W00002407,Output Areas and Small Areas,OASA,260,12,248
285148,W00002408,W00002408,Output Areas and Small Areas,OASA,341,21,320
285149,W00002409,W00002409,Output Areas and Small Areas,OASA,266,113,153
285150,W00002410,W00002410,Output Areas and Small Areas,OASA,258,127,131
285151,W00002411,W00002411,Output Areas and Small Areas,OASA,260,106,154
285152,W00002412,W00002412,Output Areas and Small Areas,OASA,236,25,211
285153,W00002413,W00002413,Output Areas and Small Areas,OASA,277,33,244
285154,W00002414,W00002414,Output Areas and Small Areas,OASA,257,37,220
285155,W00002415,W00002415,Output Areas and Small Areas,OASA,226,23,203
285156,W00002416,W00002416,Output Areas and Small Areas,OASA,175,10,165
285157,W00002417,W00002417,Output Areas and Small Areas,OASA,190,15,175
285158,W00002418,W00002418,Output Areas and Small Areas,OASA,221,18,203
285159,W00002419,W00002419,Output Areas and Small Areas,OASA,166,7,159
285160,W00002420,W00002420,Output Areas and Small Areas,OASA,284,33,251
285161,W00002421,W00002421,Output Areas and Small Areas,OASA,210,13,197
285162,W00002422,W00002422,Output Areas and Small Areas,OASA,270,21,249
285163,W00002423,W00002423,Output Areas and Small Areas,OASA,439,40,399
285164,W00002424,W00002424,Output Areas and Small Areas,OASA,187,23,164
285165,W00002425,W00002425,Output Areas and Small Areas,OASA,208,18,190
285166,W00002426,W00002426,Output Areas and Small Areas,OASA,272,35,237
285167,W00002427,W00002427,Output Areas and Small Areas,OASA,260,27,233
285168,W00002429,W00002429,Output Areas and Small Areas,OASA,250,15,235
285169,W00002430,W00002430,Output Areas and Small Areas,OASA,127,8,119
285170,W00002431,W00002431,Output Areas and Small Areas,OASA,264,15,249
285171,W00002432,W00002432,Output Areas and Small Areas,OASA,221,12,209
285172,W00002433,W00002433,Output Areas and Small Areas,OASA,189,15,174
285173,W00002436,W00002436,Output Areas and Small Areas,OASA,336,10,326
285174,W00002437,W00002437,Output Areas and Small Areas,OASA,235,15,220
285175,W00002438,W00002438,Output Areas and Small Areas,OASA,343,26,317
285176,W00002439,W00002439,Output Areas and Small Areas,OASA,238,10,228
285177,W00002440,W00002440,Output Areas and Small Areas,OASA,310,14,296
285178,W00002441,W00002441,Output Areas and Small Areas,OASA,291,25,266
285179,W00002442,W00002442,Output Areas and Small Areas,OASA,296,13,283
285180,W00002443,W00002443,Output Areas and Small Areas,OASA,256,26,230
285181,W00002444,W00002444,Output Areas and Small Areas,OASA,391,34,357
285182,W00002445,W00002445,Output Areas and Small Areas,OASA,295,16,279
285183,W00002446,W00002446,Output Areas and Small Areas,OASA,226,15,211
285184,W00002447,W00002447,Output Areas and Small Areas,OASA,189,12,177
285185,W00002448,W00002448,Output Areas and Small Areas,OASA,262,18,244
285186,W00002449,W00002449,Output Areas and Small Areas,OASA,185,12,173
285187,W00002450,W00002450,Output Areas and Small Areas,OASA,241,20,221
285188,W00002451,W00002451,Output Areas and Small Areas,OASA,111,9,102
285189,W00002452,W00002452,Output Areas and Small Areas,OASA,310,101,209
285190,W00002453,W00002453,Output Areas and Small Areas,OASA,245,85,160
285191,W00002454,W00002454,Output Areas and Small Areas,OASA,245,63,182
285192,W00002455,W00002455,Output Areas and Small Areas,OASA,318,112,206
285193,W00002456,W00002456,Output Areas and Small Areas,OASA,321,73,248
285194,W00002457,W00002457,Output Areas and Small Areas,OASA,409,210,199
285195,W00002458,W00002458,Output Areas and Small Areas,OASA,310,92,218
285196,W00002459,W00002459,Output Areas and Small Areas,OASA,195,61,134
285197,W00002461,W00002461,Output Areas and Small Areas,OASA,351,129,222
285198,W00002463,W00002463,Output Areas and Small Areas,OASA,176,29,147
285199,W00002465,W00002465,Output Areas and Small Areas,OASA,333,22,311
285200,W00002466,W00002466,Output Areas and Small Areas,OASA,274,14,260
285201,W00002467,W00002467,Output Areas and Small Areas,OASA,224,5,219
285202,W00002468,W00002468,Output Areas and Small Areas,OASA,282,24,258
285203,W00002469,W00002469,Output Areas and Small Areas,OASA,315,19,296
285204,W00002470,W00002470,Output Areas and Small Areas,OASA,309,29,280
285205,W00002471,W00002471,Output Areas and Small Areas,OASA,244,17,227
285206,W00002472,W00002472,Output Areas and Small Areas,OASA,197,9,188
285207,W00002473,W00002473,Output Areas and Small Areas,OASA,322,13,309
285208,W00002474,W00002474,Output Areas and Small Areas,OASA,300,8,292
285209,W00002475,W00002475,Output Areas and Small Areas,OASA,281,20,261
285210,W00002476,W00002476,Output Areas and Small Areas,OASA,334,34,300
285211,W00002477,W00002477,Output Areas and Small Areas,OASA,267,19,248
285212,W00002478,W00002478,Output Areas and Small Areas,OASA,235,34,201
285213,W00002479,W00002479,Output Areas and Small Areas,OASA,225,37,188
285214,W00002480,W00002480,Output Areas and Small Areas,OASA,246,34,212
285215,W00002481,W00002481,Output Areas and Small Areas,OASA,224,34,190
285216,W00002482,W00002482,Output Areas and Small Areas,OASA,230,25,205
285217,W00002483,W00002483,Output Areas and Small Areas,OASA,236,28,208
285218,W00002484,W00002484,Output Areas and Small Areas,OASA,252,36,216
285219,W00002485,W00002485,Output Areas and Small Areas,OASA,155,21,134
285220,W00002486,W00002486,Output Areas and Small Areas,OASA,217,34,183
285221,W00002487,W00002487,Output Areas and Small Areas,OASA,222,30,192
285222,W00002488,W00002488,Output Areas and Small Areas,OASA,230,31,199
285223,W00002489,W00002489,Output Areas and Small Areas,OASA,296,96,200
285224,W00002490,W00002490,Output Areas and Small Areas,OASA,213,71,142
285225,W00002491,W00002491,Output Areas and Small Areas,OASA,179,69,110
285226,W00002492,W00002492,Output Areas and Small Areas,OASA,228,80,148
285227,W00002493,W00002493,Output Areas and Small Areas,OASA,369,168,201
285228,W00002494,W00002494,Output Areas and Small Areas,OASA,323,59,264
285229,W00002495,W00002495,Output Areas and Small Areas,OASA,346,153,193
285230,W00002496,W00002496,Output Areas and Small Areas,OASA,265,111,154
285231,W00002497,W00002497,Output Areas and Small Areas,OASA,269,50,219
285232,W00002498,W00002498,Output Areas and Small Areas,OASA,306,84,222
285233,W00002499,W00002499,Output Areas and Small Areas,OASA,216,41,175
285234,W00002500,W00002500,Output Areas and Small Areas,OASA,205,33,172
285235,W00002501,W00002501,Output Areas and Small Areas,OASA,269,51,218
285236,W00002502,W00002502,Output Areas and Small Areas,OASA,357,57,300
285237,W00002503,W00002503,Output Areas and Small Areas,OASA,254,45,209
285238,W00002504,W00002504,Output Areas and Small Areas,OASA,297,40,257
285239,W00002505,W00002505,Output Areas and Small Areas,OASA,226,22,204
285240,W00002506,W00002506,Output Areas and Small Areas,OASA,228,29,199
285241,W00002507,W00002507,Output Areas and Small Areas,OASA,295,34,261
285242,W00002508,W00002508,Output Areas and Small Areas,OASA,200,47,153
285243,W00002509,W00002509,Output Areas and Small Areas,OASA,217,31,186
285244,W00002510,W00002510,Output Areas and Small Areas,OASA,212,36,176
285245,W00002511,W00002511,Output Areas and Small Areas,OASA,205,18,187
285246,W00002512,W00002512,Output Areas and Small Areas,OASA,268,16,252
285247,W00002513,W00002513,Output Areas and Small Areas,OASA,265,23,242
285248,W00002514,W00002514,Output Areas and Small Areas,OASA,231,23,208
285249,W00002515,W00002515,Output Areas and Small Areas,OASA,210,14,196
285250,W00002516,W00002516,Output Areas and Small Areas,OASA,243,130,113
285251,W00002517,W00002517,Output Areas and Small Areas,OASA,266,125,141
285252,W00002518,W00002518,Output Areas and Small Areas,OASA,249,147,102
285253,W00002519,W00002519,Output Areas and Small Areas,OASA,214,93,121
285254,W00002520,W00002520,Output Areas and Small Areas,OASA,201,99,102
285255,W00002521,W00002521,Output Areas and Small Areas,OASA,214,92,122
285256,W00002522,W00002522,Output Areas and Small Areas,OASA,236,123,113
285257,W00002523,W00002523,Output Areas and Small Areas,OASA,210,67,143
285258,W00002524,W00002524,Output Areas and Small Areas,OASA,210,62,148
285259,W00002525,W00002525,Output Areas and Small Areas,OASA,209,36,173
285260,W00002526,W00002526,Output Areas and Small Areas,OASA,203,63,140
285261,W00002527,W00002527,Output Areas and Small Areas,OASA,240,29,211
285262,W00002528,W00002528,Output Areas and Small Areas,OASA,289,73,216
285263,W00002529,W00002529,Output Areas and Small Areas,OASA,191,35,156
285264,W00002530,W00002530,Output Areas and Small Areas,OASA,91,31,60
285265,W00002531,W00002531,Output Areas and Small Areas,OASA,270,62,208
285266,W00002532,W00002532,Output Areas and Small Areas,OASA,274,40,234
285267,W00002533,W00002533,Output Areas and Small Areas,OASA,255,70,185
285268,W00002534,W00002534,Output Areas and Small Areas,OASA,294,53,241
285269,W00002536,W00002536,Output Areas and Small Areas,OASA,253,18,235
285270,W00002537,W00002537,Output Areas and Small Areas,OASA,233,20,213
285271,W00002540,W00002540,Output Areas and Small Areas,OASA,198,13,185
285272,W00002541,W00002541,Output Areas and Small Areas,OASA,307,27,280
285273,W00002542,W00002542,Output Areas and Small Areas,OASA,242,14,228
285274,W00002543,W00002543,Output Areas and Small Areas,OASA,259,22,237
285275,W00002544,W00002544,Output Areas and Small Areas,OASA,227,14,213
285276,W00002545,W00002545,Output Areas and Small Areas,OASA,261,22,239
285277,W00002546,W00002546,Output Areas and Small Areas,OASA,190,13,177
285278,W00002547,W00002547,Output Areas and Small Areas,OASA,224,23,201
285279,W00002548,W00002548,Output Areas and Small Areas,OASA,233,28,205
285280,W00002549,W00002549,Output Areas and Small Areas,OASA,237,24,213
285281,W00002550,W00002550,Output Areas and Small Areas,OASA,191,21,170
285282,W00002551,W00002551,Output Areas and Small Areas,OASA,210,8,202
285283,W00002552,W00002552,Output Areas and Small Areas,OASA,232,25,207
285284,W00002553,W00002553,Output Areas and Small Areas,OASA,203,31,172
285285,W00002554,W00002554,Output Areas and Small Areas,OASA,219,21,198
285286,W00002555,W00002555,Output Areas and Small Areas,OASA,197,20,177
285287,W00002556,W00002556,Output Areas and Small Areas,OASA,224,10,214
285288,W00002557,W00002557,Output Areas and Small Areas,OASA,125,14,111
285289,W00002558,W00002558,Output Areas and Small Areas,OASA,159,9,150
285290,W00002560,W00002560,Output Areas and Small Areas,OASA,210,18,192
285291,W00002562,W00002562,Output Areas and Small Areas,OASA,190,18,172
285292,W00002563,W00002563,Output Areas and Small Areas,OASA,263,20,243
285293,W00002564,W00002564,Output Areas and Small Areas,OASA,326,48,278
285294,W00002565,W00002565,Output Areas and Small Areas,OASA,332,41,291
285295,W00002566,W00002566,Output Areas and Small Areas,OASA,246,32,214
285296,W00002567,W00002567,Output Areas and Small Areas,OASA,268,28,240
285297,W00002568,W00002568,Output Areas and Small Areas,OASA,269,34,235
285298,W00002569,W00002569,Output Areas and Small Areas,OASA,293,35,258
285299,W00002570,W00002570,Output Areas and Small Areas,OASA,176,11,165
285300,W00002571,W00002571,Output Areas and Small Areas,OASA,167,20,147
285301,W00002573,W00002573,Output Areas and Small Areas,OASA,196,22,174
285302,W00002574,W00002574,Output Areas and Small Areas,OASA,133,10,123
285303,W00002575,W00002575,Output Areas and Small Areas,OASA,167,16,151
285304,W00002576,W00002576,Output Areas and Small Areas,OASA,196,25,171
285305,W00002577,W00002577,Output Areas and Small Areas,OASA,245,24,221
285306,W00002578,W00002578,Output Areas and Small Areas,OASA,233,18,215
285307,W00002579,W00002579,Output Areas and Small Areas,OASA,249,23,226
285308,W00002580,W00002580,Output Areas and Small Areas,OASA,206,22,184
285309,W00002581,W00002581,Output Areas and Small Areas,OASA,253,19,234
285310,W00002582,W00002582,Output Areas and Small Areas,OASA,211,21,190
285311,W00002583,W00002583,Output Areas and Small Areas,OASA,350,9,341
285312,W00002584,W00002584,Output Areas and Small Areas,OASA,151,6,145
285313,W00002585,W00002585,Output Areas and Small Areas,OASA,202,8,194
285314,W00002586,W00002586,Output Areas and Small Areas,OASA,219,6,213
285315,W00002587,W00002587,Output Areas and Small Areas,OASA,200,9,191
285316,W00002588,W00002588,Output Areas and Small Areas,OASA,221,5,216
285317,W00002589,W00002589,Output Areas and Small Areas,OASA,228,5,223
285318,W00002590,W00002590,Output Areas and Small Areas,OASA,289,12,277
285319,W00002591,W00002591,Output Areas and Small Areas,OASA,224,17,207
285320,W00002592,W00002592,Output Areas and Small Areas,OASA,201,10,191
285321,W00002593,W00002593,Output Areas and Small Areas,OASA,300,13,287
285322,W00002594,W00002594,Output Areas and Small Areas,OASA,250,13,237
285323,W00002595,W00002595,Output Areas and Small Areas,OASA,200,4,196
285324,W00002596,W00002596,Output Areas and Small Areas,OASA,346,14,332
285325,W00002597,W00002597,Output Areas and Small Areas,OASA,257,10,247
285326,W00002598,W00002598,Output Areas and Small Areas,OASA,212,21,191
285327,W00002599,W00002599,Output Areas and Small Areas,OASA,304,24,280
285328,W00002600,W00002600,Output Areas and Small Areas,OASA,243,23,220
285329,W00002601,W00002601,Output Areas and Small Areas,OASA,290,18,272
285330,W00002602,W00002602,Output Areas and Small Areas,OASA,222,23,199
285331,W00002603,W00002603,Output Areas and Small Areas,OASA,256,17,239
285332,W00002604,W00002604,Output Areas and Small Areas,OASA,236,19,217
285333,W00002605,W00002605,Output Areas and Small Areas,OASA,351,44,307
285334,W00002606,W00002606,Output Areas and Small Areas,OASA,474,97,377
285335,W00002607,W00002607,Output Areas and Small Areas,OASA,265,43,222
285336,W00002608,W00002608,Output Areas and Small Areas,OASA,320,55,265
285337,W00002609,W00002609,Output Areas and Small Areas,OASA,391,58,333
285338,W00002610,W00002610,Output Areas and Small Areas,OASA,205,25,180
285339,W00002611,W00002611,Output Areas and Small Areas,OASA,244,22,222
285340,W00002612,W00002612,Output Areas and Small Areas,OASA,286,21,265
285341,W00002613,W00002613,Output Areas and Small Areas,OASA,206,14,192
285342,W00002614,W00002614,Output Areas and Small Areas,OASA,182,9,173
285343,W00002615,W00002615,Output Areas and Small Areas,OASA,308,28,280
285344,W00002616,W00002616,Output Areas and Small Areas,OASA,230,28,202
285345,W00002619,W00002619,Output Areas and Small Areas,OASA,284,38,246
285346,W00002620,W00002620,Output Areas and Small Areas,OASA,193,10,183
285347,W00002621,W00002621,Output Areas and Small Areas,OASA,198,21,177
285348,W00002622,W00002622,Output Areas and Small Areas,OASA,211,25,186
285349,W00002623,W00002623,Output Areas and Small Areas,OASA,232,12,220
285350,W00002624,W00002624,Output Areas and Small Areas,OASA,259,11,248
285351,W00002625,W00002625,Output Areas and Small Areas,OASA,228,20,208
285352,W00002627,W00002627,Output Areas and Small Areas,OASA,364,38,326
285353,W00002628,W00002628,Output Areas and Small Areas,OASA,251,24,227
285354,W00002629,W00002629,Output Areas and Small Areas,OASA,203,22,181
285355,W00002630,W00002630,Output Areas and Small Areas,OASA,259,32,227
285356,W00002631,W00002631,Output Areas and Small Areas,OASA,195,19,176
285357,W00002632,W00002632,Output Areas and Small Areas,OASA,224,20,204
285358,W00002633,W00002633,Output Areas and Small Areas,OASA,231,16,215
285359,W00002634,W00002634,Output Areas and Small Areas,OASA,227,17,210
285360,W00002635,W00002635,Output Areas and Small Areas,OASA,362,23,339
285361,W00002636,W00002636,Output Areas and Small Areas,OASA,258,27,231
285362,W00002637,W00002637,Output Areas and Small Areas,OASA,242,20,222
285363,W00002638,W00002638,Output Areas and Small Areas,OASA,300,23,277
285364,W00002641,W00002641,Output Areas and Small Areas,OASA,374,30,344
285365,W00002642,W00002642,Output Areas and Small Areas,OASA,230,23,207
285366,W00002643,W00002643,Output Areas and Small Areas,OASA,310,42,268
285367,W00002644,W00002644,Output Areas and Small Areas,OASA,232,15,217
285368,W00002645,W00002645,Output Areas and Small Areas,OASA,256,13,243
285369,W00002646,W00002646,Output Areas and Small Areas,OASA,215,25,190
285370,W00002648,W00002648,Output Areas and Small Areas,OASA,179,25,154
285371,W00002649,W00002649,Output Areas and Small Areas,OASA,330,90,240
285372,W00002650,W00002650,Output Areas and Small Areas,OASA,268,53,215
285373,W00002651,W00002651,Output Areas and Small Areas,OASA,251,78,173
285374,W00002652,W00002652,Output Areas and Small Areas,OASA,220,48,172
285375,W00002653,W00002653,Output Areas and Small Areas,OASA,241,56,185
285376,W00002654,W00002654,Output Areas and Small Areas,OASA,157,36,121
285377,W00002655,W00002655,Output Areas and Small Areas,OASA,322,57,265
285378,W00002656,W00002656,Output Areas and Small Areas,OASA,391,37,354
285379,W00002657,W00002657,Output Areas and Small Areas,OASA,226,14,212
285380,W00002658,W00002658,Output Areas and Small Areas,OASA,229,25,204
285381,W00002659,W00002659,Output Areas and Small Areas,OASA,279,17,262
285382,W00002660,W00002660,Output Areas and Small Areas,OASA,192,18,174
285383,W00002661,W00002661,Output Areas and Small Areas,OASA,169,13,156
285384,W00002662,W00002662,Output Areas and Small Areas,OASA,194,12,182
285385,W00002663,W00002663,Output Areas and Small Areas,OASA,214,17,197
285386,W00002664,W00002664,Output Areas and Small Areas,OASA,204,9,195
285387,W00002665,W00002665,Output Areas and Small Areas,OASA,262,9,253
285388,W00002666,W00002666,Output Areas and Small Areas,OASA,313,21,292
285389,W00002667,W00002667,Output Areas and Small Areas,OASA,325,29,296
285390,W00002668,W00002668,Output Areas and Small Areas,OASA,231,23,208
285391,W00002669,W00002669,Output Areas and Small Areas,OASA,242,19,223
285392,W00002670,W00002670,Output Areas and Small Areas,OASA,283,24,259
285393,W00002671,W00002671,Output Areas and Small Areas,OASA,248,26,222
285394,W00002672,W00002672,Output Areas and Small Areas,OASA,194,14,180
285395,W00002673,W00002673,Output Areas and Small Areas,OASA,263,25,238
285396,W00002674,W00002674,Output Areas and Small Areas,OASA,237,14,223
285397,W00002675,W00002675,Output Areas and Small Areas,OASA,198,9,189
285398,W00002676,W00002676,Output Areas and Small Areas,OASA,222,16,206
285399,W00002677,W00002677,Output Areas and Small Areas,OASA,201,12,189
285400,W00002678,W00002678,Output Areas and Small Areas,OASA,242,34,208
285401,W00002679,W00002679,Output Areas and Small Areas,OASA,136,19,117
285402,W00002680,W00002680,Output Areas and Small Areas,OASA,326,44,282
285403,W00002681,W00002681,Output Areas and Small Areas,OASA,149,18,131
285404,W00002682,W00002682,Output Areas and Small Areas,OASA,222,20,202
285405,W00002683,W00002683,Output Areas and Small Areas,OASA,206,25,181
285406,W00002684,W00002684,Output Areas and Small Areas,OASA,221,106,115
285407,W00002685,W00002685,Output Areas and Small Areas,OASA,230,89,141
285408,W00002686,W00002686,Output Areas and Small Areas,OASA,227,99,128
285409,W00002687,W00002687,Output Areas and Small Areas,OASA,222,105,117
285410,W00002688,W00002688,Output Areas and Small Areas,OASA,223,96,127
285411,W00002689,W00002689,Output Areas and Small Areas,OASA,294,156,138
285412,W00002690,W00002690,Output Areas and Small Areas,OASA,146,44,102
285413,W00002691,W00002691,Output Areas and Small Areas,OASA,208,103,105
285414,W00002692,W00002692,Output Areas and Small Areas,OASA,210,33,177
285415,W00002693,W00002693,Output Areas and Small Areas,OASA,302,35,267
285416,W00002694,W00002694,Output Areas and Small Areas,OASA,366,52,314
285417,W00002695,W00002695,Output Areas and Small Areas,OASA,295,127,168
285418,W00002696,W00002696,Output Areas and Small Areas,OASA,202,87,115
285419,W00002697,W00002697,Output Areas and Small Areas,OASA,249,114,135
285420,W00002698,W00002698,Output Areas and Small Areas,OASA,233,109,124
285421,W00002699,W00002699,Output Areas and Small Areas,OASA,221,77,144
285422,W00002700,W00002700,Output Areas and Small Areas,OASA,223,50,173
285423,W00002701,W00002701,Output Areas and Small Areas,OASA,202,81,121
285424,W00002702,W00002702,Output Areas and Small Areas,OASA,248,94,154
285425,W00002703,W00002703,Output Areas and Small Areas,OASA,242,97,145
285426,W00002704,W00002704,Output Areas and Small Areas,OASA,225,137,88
285427,W00002705,W00002705,Output Areas and Small Areas,OASA,244,166,78
285428,W00002706,W00002706,Output Areas and Small Areas,OASA,209,117,92
285429,W00002707,W00002707,Output Areas and Small Areas,OASA,180,82,98
285430,W00002708,W00002708,Output Areas and Small Areas,OASA,186,97,89
285431,W00002709,W00002709,Output Areas and Small Areas,OASA,204,121,83
285432,W00002710,W00002710,Output Areas and Small Areas,OASA,154,61,93
285433,W00002711,W00002711,Output Areas and Small Areas,OASA,429,167,262
285434,W00002712,W00002712,Output Areas and Small Areas,OASA,158,50,108
285435,W00002713,W00002713,Output Areas and Small Areas,OASA,211,87,124
285436,W00002714,W00002714,Output Areas and Small Areas,OASA,265,85,180
285437,W00002715,W00002715,Output Areas and Small Areas,OASA,226,89,137
285438,W00002716,W00002716,Output Areas and Small Areas,OASA,285,125,160
285439,W00002717,W00002717,Output Areas and Small Areas,OASA,108,61,47
285440,W00002718,W00002718,Output Areas and Small Areas,OASA,184,71,113
285441,W00002719,W00002719,Output Areas and Small Areas,OASA,307,143,164
285442,W00002720,W00002720,Output Areas and Small Areas,OASA,197,113,84
285443,W00002721,W00002721,Output Areas and Small Areas,OASA,210,119,91
285444,W00002722,W00002722,Output Areas and Small Areas,OASA,244,147,97
285445,W00002723,W00002723,Output Areas and Small Areas,OASA,162,93,69
285446,W00002724,W00002724,Output Areas and Small Areas,OASA,181,107,74
285447,W00002725,W00002725,Output Areas and Small Areas,OASA,187,100,87
285448,W00002726,W00002726,Output Areas and Small Areas,OASA,211,116,95
285449,W00002727,W00002727,Output Areas and Small Areas,OASA,181,114,67
285450,W00002728,W00002728,Output Areas and Small Areas,OASA,257,138,119
285451,W00002729,W00002729,Output Areas and Small Areas,OASA,179,77,102
285452,W00002730,W00002730,Output Areas and Small Areas,OASA,202,96,106
285453,W00002731,W00002731,Output Areas and Small Areas,OASA,266,103,163
285454,W00002732,W00002732,Output Areas and Small Areas,OASA,237,122,115
285455,W00002733,W00002733,Output Areas and Small Areas,OASA,196,76,120
285456,W00002734,W00002734,Output Areas and Small Areas,OASA,228,88,140
285457,W00002736,W00002736,Output Areas and Small Areas,OASA,364,171,193
285458,W00002737,W00002737,Output Areas and Small Areas,OASA,285,116,169
285459,W00002738,W00002738,Output Areas and Small Areas,OASA,466,107,359
285460,W00002739,W00002739,Output Areas and Small Areas,OASA,303,88,215
285461,W00002740,W00002740,Output Areas and Small Areas,OASA,430,86,344
285462,W00002741,W00002741,Output Areas and Small Areas,OASA,310,101,209
285463,W00002742,W00002742,Output Areas and Small Areas,OASA,337,79,258
285464,W00002743,W00002743,Output Areas and Small Areas,OASA,334,69,265
285465,W00002744,W00002744,Output Areas and Small Areas,OASA,195,52,143
285466,W00002745,W00002745,Output Areas and Small Areas,OASA,196,49,147
285467,W00002746,W00002746,Output Areas and Small Areas,OASA,265,83,182
285468,W00002747,W00002747,Output Areas and Small Areas,OASA,326,94,232
285469,W00002748,W00002748,Output Areas and Small Areas,OASA,335,114,221
285470,W00002751,W00002751,Output Areas and Small Areas,OASA,268,69,199
285471,W00002752,W00002752,Output Areas and Small Areas,OASA,308,88,220
285472,W00002753,W00002753,Output Areas and Small Areas,OASA,285,99,186
285473,W00002754,W00002754,Output Areas and Small Areas,OASA,270,121,149
285474,W00002755,W00002755,Output Areas and Small Areas,OASA,240,78,162
285475,W00002756,W00002756,Output Areas and Small Areas,OASA,268,99,169
285476,W00002757,W00002757,Output Areas and Small Areas,OASA,194,80,114
285477,W00002758,W00002758,Output Areas and Small Areas,OASA,214,71,143
285478,W00002759,W00002759,Output Areas and Small Areas,OASA,240,64,176
285479,W00002760,W00002760,Output Areas and Small Areas,OASA,212,53,159
285480,W00002761,W00002761,Output Areas and Small Areas,OASA,241,75,166
285481,W00002762,W00002762,Output Areas and Small Areas,OASA,304,94,210
285482,W00002763,W00002763,Output Areas and Small Areas,OASA,319,79,240
285483,W00002764,W00002764,Output Areas and Small Areas,OASA,326,99,227
285484,W00002765,W00002765,Output Areas and Small Areas,OASA,258,98,160
285485,W00002766,W00002766,Output Areas and Small Areas,OASA,355,83,272
285486,W00002767,W00002767,Output Areas and Small Areas,OASA,206,53,153
285487,W00002768,W00002768,Output Areas and Small Areas,OASA,130,51,79
285488,W00002769,W00002769,Output Areas and Small Areas,OASA,258,65,193
285489,W00002770,W00002770,Output Areas and Small Areas,OASA,267,87,180
285490,W00002771,W00002771,Output Areas and Small Areas,OASA,381,93,288
285491,W00002772,W00002772,Output Areas and Small Areas,OASA,259,149,110
285492,W00002773,W00002773,Output Areas and Small Areas,OASA,215,102,113
285493,W00002774,W00002774,Output Areas and Small Areas,OASA,244,119,125
285494,W00002775,W00002775,Output Areas and Small Areas,OASA,206,77,129
285495,W00002776,W00002776,Output Areas and Small Areas,OASA,255,117,138
285496,W00002777,W00002777,Output Areas and Small Areas,OASA,227,116,111
285497,W00002778,W00002778,Output Areas and Small Areas,OASA,215,49,166
285498,W00002779,W00002779,Output Areas and Small Areas,OASA,185,47,138
285499,W00002780,W00002780,Output Areas and Small Areas,OASA,189,36,153
285500,W00002781,W00002781,Output Areas and Small Areas,OASA,249,87,162
285501,W00002782,W00002782,Output Areas and Small Areas,OASA,243,76,167
285502,W00002783,W00002783,Output Areas and Small Areas,OASA,114,22,92
285503,W00002784,W00002784,Output Areas and Small Areas,OASA,284,163,121
285504,W00002785,W00002785,Output Areas and Small Areas,OASA,264,119,145
285505,W00002786,W00002786,Output Areas and Small Areas,OASA,234,120,114
285506,W00002787,W00002787,Output Areas and Small Areas,OASA,225,92,133
285507,W00002788,W00002788,Output Areas and Small Areas,OASA,254,118,136
285508,W00002789,W00002789,Output Areas and Small Areas,OASA,196,75,121
285509,W00002790,W00002790,Output Areas and Small Areas,OASA,212,108,104
285510,W00002791,W00002791,Output Areas and Small Areas,OASA,279,157,122
285511,W00002792,W00002792,Output Areas and Small Areas,OASA,272,135,137
285512,W00002793,W00002793,Output Areas and Small Areas,OASA,268,150,118
285513,W00002794,W00002794,Output Areas and Small Areas,OASA,238,113,125
285514,W00002795,W00002795,Output Areas and Small Areas,OASA,261,104,157
285515,W00002796,W00002796,Output Areas and Small Areas,OASA,250,85,165
285516,W00002797,W00002797,Output Areas and Small Areas,OASA,303,161,142
285517,W00002798,W00002798,Output Areas and Small Areas,OASA,228,115,113
285518,W00002799,W00002799,Output Areas and Small Areas,OASA,227,97,130
285519,W00002800,W00002800,Output Areas and Small Areas,OASA,182,95,87
285520,W00002801,W00002801,Output Areas and Small Areas,OASA,237,114,123
285521,W00002802,W00002802,Output Areas and Small Areas,OASA,235,130,105
285522,W00002803,W00002803,Output Areas and Small Areas,OASA,225,97,128
285523,W00002805,W00002805,Output Areas and Small Areas,OASA,215,88,127
285524,W00002806,W00002806,Output Areas and Small Areas,OASA,316,144,172
285525,W00002807,W00002807,Output Areas and Small Areas,OASA,233,101,132
285526,W00002808,W00002808,Output Areas and Small Areas,OASA,290,132,158
285527,W00002809,W00002809,Output Areas and Small Areas,OASA,220,86,134
285528,W00002811,W00002811,Output Areas and Small Areas,OASA,230,148,82
285529,W00002812,W00002812,Output Areas and Small Areas,OASA,277,135,142
285530,W00002813,W00002813,Output Areas and Small Areas,OASA,189,96,93
285531,W00002814,W00002814,Output Areas and Small Areas,OASA,325,167,158
285532,W00002815,W00002815,Output Areas and Small Areas,OASA,240,132,108
285533,W00002816,W00002816,Output Areas and Small Areas,OASA,216,120,96
285534,W00002818,W00002818,Output Areas and Small Areas,OASA,159,65,94
285535,W00002819,W00002819,Output Areas and Small Areas,OASA,214,123,91
285536,W00002820,W00002820,Output Areas and Small Areas,OASA,410,205,205
285537,W00002821,W00002821,Output Areas and Small Areas,OASA,269,129,140
285538,W00002822,W00002822,Output Areas and Small Areas,OASA,224,89,135
285539,W00002823,W00002823,Output Areas and Small Areas,OASA,281,111,170
285540,W00002824,W00002824,Output Areas and Small Areas,OASA,124,55,69
285541,W00002825,W00002825,Output Areas and Small Areas,OASA,202,73,129
285542,W00002826,W00002826,Output Areas and Small Areas,OASA,168,59,109
285543,W00002827,W00002827,Output Areas and Small Areas,OASA,213,73,140
285544,W00002828,W00002828,Output Areas and Small Areas,OASA,283,127,156
285545,W00002829,W00002829,Output Areas and Small Areas,OASA,174,59,115
285546,W00002831,W00002831,Output Areas and Small Areas,OASA,1445,198,1247
285547,W00002832,W00002832,Output Areas and Small Areas,OASA,224,108,116
285548,W00002833,W00002833,Output Areas and Small Areas,OASA,200,97,103
285549,W00002834,W00002834,Output Areas and Small Areas,OASA,442,205,237
285550,W00002835,W00002835,Output Areas and Small Areas,OASA,126,79,47
285551,W00002836,W00002836,Output Areas and Small Areas,OASA,232,132,100
285552,W00002837,W00002837,Output Areas and Small Areas,OASA,313,151,162
285553,W00002838,W00002838,Output Areas and Small Areas,OASA,278,180,98
285554,W00002839,W00002839,Output Areas and Small Areas,OASA,181,67,114
285555,W00002840,W00002840,Output Areas and Small Areas,OASA,200,68,132
285556,W00002841,W00002841,Output Areas and Small Areas,OASA,275,130,145
285557,W00002842,W00002842,Output Areas and Small Areas,OASA,345,132,213
285558,W00002843,W00002843,Output Areas and Small Areas,OASA,252,115,137
285559,W00002844,W00002844,Output Areas and Small Areas,OASA,152,78,74
285560,W00002845,W00002845,Output Areas and Small Areas,OASA,256,175,81
285561,W00002846,W00002846,Output Areas and Small Areas,OASA,218,132,86
285562,W00002847,W00002847,Output Areas and Small Areas,OASA,169,101,68
285563,W00002848,W00002848,Output Areas and Small Areas,OASA,170,73,97
285564,W00002849,W00002849,Output Areas and Small Areas,OASA,229,125,104
285565,W00002850,W00002850,Output Areas and Small Areas,OASA,144,91,53
285566,W00002851,W00002851,Output Areas and Small Areas,OASA,325,171,154
285567,W00002852,W00002852,Output Areas and Small Areas,OASA,236,113,123
285568,W00002853,W00002853,Output Areas and Small Areas,OASA,236,110,126
285569,W00002854,W00002854,Output Areas and Small Areas,OASA,221,116,105
285570,W00002855,W00002855,Output Areas and Small Areas,OASA,220,105,115
285571,W00002856,W00002856,Output Areas and Small Areas,OASA,292,178,114
285572,W00002857,W00002857,Output Areas and Small Areas,OASA,227,123,104
285573,W00002858,W00002858,Output Areas and Small Areas,OASA,294,165,129
285574,W00002859,W00002859,Output Areas and Small Areas,OASA,153,64,89
285575,W00002860,W00002860,Output Areas and Small Areas,OASA,198,129,69
285576,W00002861,W00002861,Output Areas and Small Areas,OASA,262,87,175
285577,W00002862,W00002862,Output Areas and Small Areas,OASA,260,122,138
285578,W00002863,W00002863,Output Areas and Small Areas,OASA,270,140,130
285579,W00002864,W00002864,Output Areas and Small Areas,OASA,257,129,128
285580,W00002865,W00002865,Output Areas and Small Areas,OASA,230,129,101
285581,W00002866,W00002866,Output Areas and Small Areas,OASA,225,96,129
285582,W00002867,W00002867,Output Areas and Small Areas,OASA,249,117,132
285583,W00002868,W00002868,Output Areas and Small Areas,OASA,178,50,128
285584,W00002869,W00002869,Output Areas and Small Areas,OASA,191,84,107
285585,W00002870,W00002870,Output Areas and Small Areas,OASA,171,66,105
285586,W00002871,W00002871,Output Areas and Small Areas,OASA,189,97,92
285587,W00002872,W00002872,Output Areas and Small Areas,OASA,177,97,80
285588,W00002873,W00002873,Output Areas and Small Areas,OASA,182,90,92
285589,W00002874,W00002874,Output Areas and Small Areas,OASA,160,63,97
285590,W00002875,W00002875,Output Areas and Small Areas,OASA,251,130,121
285591,W00002876,W00002876,Output Areas and Small Areas,OASA,244,137,107
285592,W00002877,W00002877,Output Areas and Small Areas,OASA,265,142,123
285593,W00002878,W00002878,Output Areas and Small Areas,OASA,257,120,137
285594,W00002879,W00002879,Output Areas and Small Areas,OASA,268,146,122
285595,W00002880,W00002880,Output Areas and Small Areas,OASA,298,131,167
285596,W00002881,W00002881,Output Areas and Small Areas,OASA,262,128,134
285597,W00002882,W00002882,Output Areas and Small Areas,OASA,230,97,133
285598,W00002883,W00002883,Output Areas and Small Areas,OASA,206,98,108
285599,W00002884,W00002884,Output Areas and Small Areas,OASA,287,161,126
285600,W00002885,W00002885,Output Areas and Small Areas,OASA,273,112,161
285601,W00002886,W00002886,Output Areas and Small Areas,OASA,257,112,145
285602,W00002887,W00002887,Output Areas and Small Areas,OASA,221,124,97
285603,W00002888,W00002888,Output Areas and Small Areas,OASA,253,141,112
285604,W00002889,W00002889,Output Areas and Small Areas,OASA,219,102,117
285605,W00002890,W00002890,Output Areas and Small Areas,OASA,248,127,121
285606,W00002891,W00002891,Output Areas and Small Areas,OASA,219,118,101
285607,W00002892,W00002892,Output Areas and Small Areas,OASA,197,101,96
285608,W00002893,W00002893,Output Areas and Small Areas,OASA,225,129,96
285609,W00002894,W00002894,Output Areas and Small Areas,OASA,182,118,64
285610,W00002895,W00002895,Output Areas and Small Areas,OASA,275,133,142
285611,W00002896,W00002896,Output Areas and Small Areas,OASA,329,164,165
285612,W00002897,W00002897,Output Areas and Small Areas,OASA,224,88,136
285613,W00002898,W00002898,Output Areas and Small Areas,OASA,127,52,75
285614,W00002899,W00002899,Output Areas and Small Areas,OASA,256,159,97
285615,W00002900,W00002900,Output Areas and Small Areas,OASA,324,168,156
285616,W00002901,W00002901,Output Areas and Small Areas,OASA,300,144,156
285617,W00002902,W00002902,Output Areas and Small Areas,OASA,189,82,107
285618,W00002903,W00002903,Output Areas and Small Areas,OASA,202,64,138
285619,W00002904,W00002904,Output Areas and Small Areas,OASA,208,100,108
285620,W00002905,W00002905,Output Areas and Small Areas,OASA,227,128,99
285621,W00002906,W00002906,Output Areas and Small Areas,OASA,226,111,115
285622,W00002907,W00002907,Output Areas and Small Areas,OASA,224,111,113
285623,W00002908,W00002908,Output Areas and Small Areas,OASA,170,58,112
285624,W00002909,W00002909,Output Areas and Small Areas,OASA,216,84,132
285625,W00002910,W00002910,Output Areas and Small Areas,OASA,298,77,221
285626,W00002911,W00002911,Output Areas and Small Areas,OASA,151,54,97
285627,W00002912,W00002912,Output Areas and Small Areas,OASA,239,96,143
285628,W00002913,W00002913,Output Areas and Small Areas,OASA,209,99,110
285629,W00002914,W00002914,Output Areas and Small Areas,OASA,226,87,139
285630,W00002915,W00002915,Output Areas and Small Areas,OASA,245,108,137
285631,W00002916,W00002916,Output Areas and Small Areas,OASA,187,77,110
285632,W00002917,W00002917,Output Areas and Small Areas,OASA,250,108,142
285633,W00002918,W00002918,Output Areas and Small Areas,OASA,286,141,145
285634,W00002919,W00002919,Output Areas and Small Areas,OASA,301,128,173
285635,W00002920,W00002920,Output Areas and Small Areas,OASA,283,130,153
285636,W00002921,W00002921,Output Areas and Small Areas,OASA,280,117,163
285637,W00002922,W00002922,Output Areas and Small Areas,OASA,251,111,140
285638,W00002923,W00002923,Output Areas and Small Areas,OASA,209,128,81
285639,W00002924,W00002924,Output Areas and Small Areas,OASA,236,85,151
285640,W00002925,W00002925,Output Areas and Small Areas,OASA,304,142,162
285641,W00002926,W00002926,Output Areas and Small Areas,OASA,208,114,94
285642,W00002927,W00002927,Output Areas and Small Areas,OASA,176,117,59
285643,W00002928,W00002928,Output Areas and Small Areas,OASA,298,176,122
285644,W00002929,W00002929,Output Areas and Small Areas,OASA,132,45,87
285645,W00002930,W00002930,Output Areas and Small Areas,OASA,240,122,118
285646,W00002931,W00002931,Output Areas and Small Areas,OASA,155,62,93
285647,W00002932,W00002932,Output Areas and Small Areas,OASA,254,140,114
285648,W00002933,W00002933,Output Areas and Small Areas,OASA,305,158,147
285649,W00002934,W00002934,Output Areas and Small Areas,OASA,178,97,81
285650,W00002935,W00002935,Output Areas and Small Areas,OASA,257,122,135
285651,W00002936,W00002936,Output Areas and Small Areas,OASA,182,99,83
285652,W00002937,W00002937,Output Areas and Small Areas,OASA,218,103,115
285653,W00002938,W00002938,Output Areas and Small Areas,OASA,438,223,215
285654,W00002939,W00002939,Output Areas and Small Areas,OASA,298,148,150
285655,W00002940,W00002940,Output Areas and Small Areas,OASA,317,187,130
285656,W00002941,W00002941,Output Areas and Small Areas,OASA,218,161,57
285657,W00002942,W00002942,Output Areas and Small Areas,OASA,242,140,102
285658,W00002943,W00002943,Output Areas and Small Areas,OASA,262,149,113
285659,W00002944,W00002944,Output Areas and Small Areas,OASA,287,189,98
285660,W00002945,W00002945,Output Areas and Small Areas,OASA,218,107,111
285661,W00002946,W00002946,Output Areas and Small Areas,OASA,212,71,141
285662,W00002947,W00002947,Output Areas and Small Areas,OASA,225,112,113
285663,W00002948,W00002948,Output Areas and Small Areas,OASA,212,82,130
285664,W00002949,W00002949,Output Areas and Small Areas,OASA,231,122,109
285665,W00002950,W00002950,Output Areas and Small Areas,OASA,310,161,149
285666,W00002951,W00002951,Output Areas and Small Areas,OASA,243,123,120
285667,W00002952,W00002952,Output Areas and Small Areas,OASA,314,177,137
285668,W00002953,W00002953,Output Areas and Small Areas,OASA,241,131,110
285669,W00002954,W00002954,Output Areas and Small Areas,OASA,315,137,178
285670,W00002955,W00002955,Output Areas and Small Areas,OASA,241,137,104
285671,W00002956,W00002956,Output Areas and Small Areas,OASA,320,37,283
285672,W00002957,W00002957,Output Areas and Small Areas,OASA,223,11,212
285673,W00002958,W00002958,Output Areas and Small Areas,OASA,305,28,277
285674,W00002959,W00002959,Output Areas and Small Areas,OASA,232,12,220
285675,W00002960,W00002960,Output Areas and Small Areas,OASA,338,19,319
285676,W00002961,W00002961,Output Areas and Small Areas,OASA,185,14,171
285677,W00002962,W00002962,Output Areas and Small Areas,OASA,220,18,202
285678,W00002963,W00002963,Output Areas and Small Areas,OASA,290,16,274
285679,W00002964,W00002964,Output Areas and Small Areas,OASA,478,48,430
285680,W00002965,W00002965,Output Areas and Small Areas,OASA,482,49,433
285681,W00002966,W00002966,Output Areas and Small Areas,OASA,194,26,168
285682,W00002967,W00002967,Output Areas and Small Areas,OASA,289,48,241
285683,W00002968,W00002968,Output Areas and Small Areas,OASA,203,26,177
285684,W00002969,W00002969,Output Areas and Small Areas,OASA,337,50,287
285685,W00002970,W00002970,Output Areas and Small Areas,OASA,196,24,172
285686,W00002971,W00002971,Output Areas and Small Areas,OASA,98,19,79
285687,W00002972,W00002972,Output Areas and Small Areas,OASA,307,24,283
285688,W00002973,W00002973,Output Areas and Small Areas,OASA,105,14,91
285689,W00002974,W00002974,Output Areas and Small Areas,OASA,279,30,249
285690,W00002975,W00002975,Output Areas and Small Areas,OASA,361,31,330
285691,W00002976,W00002976,Output Areas and Small Areas,OASA,280,24,256
285692,W00002977,W00002977,Output Areas and Small Areas,OASA,298,27,271
285693,W00002978,W00002978,Output Areas and Small Areas,OASA,230,95,135
285694,W00002979,W00002979,Output Areas and Small Areas,OASA,270,124,146
285695,W00002980,W00002980,Output Areas and Small Areas,OASA,209,86,123
285696,W00002981,W00002981,Output Areas and Small Areas,OASA,235,114,121
285697,W00002982,W00002982,Output Areas and Small Areas,OASA,283,154,129
285698,W00002983,W00002983,Output Areas and Small Areas,OASA,223,97,126
285699,W00002984,W00002984,Output Areas and Small Areas,OASA,225,93,132
285700,W00002985,W00002985,Output Areas and Small Areas,OASA,275,145,130
285701,W00002986,W00002986,Output Areas and Small Areas,OASA,352,215,137
285702,W00002987,W00002987,Output Areas and Small Areas,OASA,306,133,173
285703,W00002988,W00002988,Output Areas and Small Areas,OASA,289,136,153
285704,W00002989,W00002989,Output Areas and Small Areas,OASA,314,164,150
285705,W00002990,W00002990,Output Areas and Small Areas,OASA,333,240,93
285706,W00002991,W00002991,Output Areas and Small Areas,OASA,221,143,78
285707,W00002992,W00002992,Output Areas and Small Areas,OASA,179,86,93
285708,W00002993,W00002993,Output Areas and Small Areas,OASA,366,137,229
285709,W00002994,W00002994,Output Areas and Small Areas,OASA,307,199,108
285710,W00002995,W00002995,Output Areas and Small Areas,OASA,312,169,143
285711,W00002996,W00002996,Output Areas and Small Areas,OASA,261,152,109
285712,W00002997,W00002997,Output Areas and Small Areas,OASA,285,112,173
285713,W00002998,W00002998,Output Areas and Small Areas,OASA,188,82,106
285714,W00002999,W00002999,Output Areas and Small Areas,OASA,256,105,151
285715,W00003000,W00003000,Output Areas and Small Areas,OASA,221,99,122
285716,W00003001,W00003001,Output Areas and Small Areas,OASA,238,111,127
285717,W00003002,W00003002,Output Areas and Small Areas,OASA,261,21,240
285718,W00003003,W00003003,Output Areas and Small Areas,OASA,257,17,240
285719,W00003004,W00003004,Output Areas and Small Areas,OASA,256,24,232
285720,W00003005,W00003005,Output Areas and Small Areas,OASA,241,13,228
285721,W00003006,W00003006,Output Areas and Small Areas,OASA,248,19,229
285722,W00003007,W00003007,Output Areas and Small Areas,OASA,288,37,251
285723,W00003008,W00003008,Output Areas and Small Areas,OASA,198,17,181
285724,W00003009,W00003009,Output Areas and Small Areas,OASA,287,18,269
285725,W00003010,W00003010,Output Areas and Small Areas,OASA,288,87,201
285726,W00003011,W00003011,Output Areas and Small Areas,OASA,259,84,175
285727,W00003012,W00003012,Output Areas and Small Areas,OASA,293,94,199
285728,W00003013,W00003013,Output Areas and Small Areas,OASA,270,78,192
285729,W00003014,W00003014,Output Areas and Small Areas,OASA,231,84,147
285730,W00003015,W00003015,Output Areas and Small Areas,OASA,244,68,176
285731,W00003016,W00003016,Output Areas and Small Areas,OASA,233,80,153
285732,W00003017,W00003017,Output Areas and Small Areas,OASA,257,74,183
285733,W00003018,W00003018,Output Areas and Small Areas,OASA,236,88,148
285734,W00003019,W00003019,Output Areas and Small Areas,OASA,256,65,191
285735,W00003020,W00003020,Output Areas and Small Areas,OASA,297,111,186
285736,W00003021,W00003021,Output Areas and Small Areas,OASA,272,61,211
285737,W00003022,W00003022,Output Areas and Small Areas,OASA,285,70,215
285738,W00003023,W00003023,Output Areas and Small Areas,OASA,292,78,214
285739,W00003024,W00003024,Output Areas and Small Areas,OASA,233,50,183
285740,W00003025,W00003025,Output Areas and Small Areas,OASA,232,44,188
285741,W00003026,W00003026,Output Areas and Small Areas,OASA,302,76,226
285742,W00003027,W00003027,Output Areas and Small Areas,OASA,212,28,184
285743,W00003028,W00003028,Output Areas and Small Areas,OASA,238,23,215
285744,W00003029,W00003029,Output Areas and Small Areas,OASA,229,31,198
285745,W00003030,W00003030,Output Areas and Small Areas,OASA,281,35,246
285746,W00003031,W00003031,Output Areas and Small Areas,OASA,271,27,244
285747,W00003032,W00003032,Output Areas and Small Areas,OASA,228,27,201
285748,W00003033,W00003033,Output Areas and Small Areas,OASA,248,39,209
285749,W00003034,W00003034,Output Areas and Small Areas,OASA,214,21,193
285750,W00003035,W00003035,Output Areas and Small Areas,OASA,179,15,164
285751,W00003036,W00003036,Output Areas and Small Areas,OASA,249,26,223
285752,W00003037,W00003037,Output Areas and Small Areas,OASA,264,9,255
285753,W00003038,W00003038,Output Areas and Small Areas,OASA,245,27,218
285754,W00003039,W00003039,Output Areas and Small Areas,OASA,146,13,133
285755,W00003040,W00003040,Output Areas and Small Areas,OASA,201,16,185
285756,W00003041,W00003041,Output Areas and Small Areas,OASA,256,34,222
285757,W00003042,W00003042,Output Areas and Small Areas,OASA,231,27,204
285758,W00003043,W00003043,Output Areas and Small Areas,OASA,231,21,210
285759,W00003044,W00003044,Output Areas and Small Areas,OASA,196,20,176
285760,W00003045,W00003045,Output Areas and Small Areas,OASA,295,23,272
285761,W00003046,W00003046,Output Areas and Small Areas,OASA,242,23,219
285762,W00003047,W00003047,Output Areas and Small Areas,OASA,252,32,220
285763,W00003048,W00003048,Output Areas and Small Areas,OASA,220,23,197
285764,W00003049,W00003049,Output Areas and Small Areas,OASA,228,18,210
285765,W00003050,W00003050,Output Areas and Small Areas,OASA,222,24,198
285766,W00003051,W00003051,Output Areas and Small Areas,OASA,212,26,186
285767,W00003052,W00003052,Output Areas and Small Areas,OASA,210,14,196
285768,W00003053,W00003053,Output Areas and Small Areas,OASA,260,36,224
285769,W00003054,W00003054,Output Areas and Small Areas,OASA,254,31,223
285770,W00003055,W00003055,Output Areas and Small Areas,OASA,219,28,191
285771,W00003056,W00003056,Output Areas and Small Areas,OASA,258,35,223
285772,W00003057,W00003057,Output Areas and Small Areas,OASA,293,71,222
285773,W00003058,W00003058,Output Areas and Small Areas,OASA,204,14,190
285774,W00003059,W00003059,Output Areas and Small Areas,OASA,238,35,203
285775,W00003060,W00003060,Output Areas and Small Areas,OASA,176,16,160
285776,W00003062,W00003062,Output Areas and Small Areas,OASA,222,20,202
285777,W00003063,W00003063,Output Areas and Small Areas,OASA,226,18,208
285778,W00003064,W00003064,Output Areas and Small Areas,OASA,201,15,186
285779,W00003065,W00003065,Output Areas and Small Areas,OASA,311,23,288
285780,W00003066,W00003066,Output Areas and Small Areas,OASA,285,12,273
285781,W00003067,W00003067,Output Areas and Small Areas,OASA,119,7,112
285782,W00003068,W00003068,Output Areas and Small Areas,OASA,379,36,343
285783,W00003069,W00003069,Output Areas and Small Areas,OASA,372,21,351
285784,W00003070,W00003070,Output Areas and Small Areas,OASA,422,34,388
285785,W00003071,W00003071,Output Areas and Small Areas,OASA,313,29,284
285786,W00003072,W00003072,Output Areas and Small Areas,OASA,301,26,275
285787,W00003073,W00003073,Output Areas and Small Areas,OASA,237,20,217
285788,W00003074,W00003074,Output Areas and Small Areas,OASA,202,17,185
285789,W00003075,W00003075,Output Areas and Small Areas,OASA,320,30,290
285790,W00003076,W00003076,Output Areas and Small Areas,OASA,191,10,181
285791,W00003077,W00003077,Output Areas and Small Areas,OASA,101,11,90
285792,W00003078,W00003078,Output Areas and Small Areas,OASA,388,46,342
285793,W00003079,W00003079,Output Areas and Small Areas,OASA,288,16,272
285794,W00003080,W00003080,Output Areas and Small Areas,OASA,260,20,240
285795,W00003081,W00003081,Output Areas and Small Areas,OASA,255,28,227
285796,W00003082,W00003082,Output Areas and Small Areas,OASA,219,15,204
285797,W00003083,W00003083,Output Areas and Small Areas,OASA,201,11,190
285798,W00003084,W00003084,Output Areas and Small Areas,OASA,331,22,309
285799,W00003085,W00003085,Output Areas and Small Areas,OASA,302,25,277
285800,W00003086,W00003086,Output Areas and Small Areas,OASA,289,52,237
285801,W00003087,W00003087,Output Areas and Small Areas,OASA,333,74,259
285802,W00003088,W00003088,Output Areas and Small Areas,OASA,375,34,341
285803,W00003089,W00003089,Output Areas and Small Areas,OASA,336,95,241
285804,W00003090,W00003090,Output Areas and Small Areas,OASA,337,20,317
285805,W00003091,W00003091,Output Areas and Small Areas,OASA,331,24,307
285806,W00003092,W00003092,Output Areas and Small Areas,OASA,239,26,213
285807,W00003093,W00003093,Output Areas and Small Areas,OASA,233,13,220
285808,W00003094,W00003094,Output Areas and Small Areas,OASA,284,15,269
285809,W00003095,W00003095,Output Areas and Small Areas,OASA,362,118,244
285810,W00003096,W00003096,Output Areas and Small Areas,OASA,331,117,214
285811,W00003097,W00003097,Output Areas and Small Areas,OASA,310,124,186
285812,W00003098,W00003098,Output Areas and Small Areas,OASA,345,112,233
285813,W00003099,W00003099,Output Areas and Small Areas,OASA,268,50,218
285814,W00003100,W00003100,Output Areas and Small Areas,OASA,269,86,183
285815,W00003101,W00003101,Output Areas and Small Areas,OASA,233,18,215
285816,W00003102,W00003102,Output Areas and Small Areas,OASA,270,33,237
285817,W00003103,W00003103,Output Areas and Small Areas,OASA,263,21,242
285818,W00003104,W00003104,Output Areas and Small Areas,OASA,274,29,245
285819,W00003105,W00003105,Output Areas and Small Areas,OASA,199,11,188
285820,W00003106,W00003106,Output Areas and Small Areas,OASA,347,36,311
285821,W00003107,W00003107,Output Areas and Small Areas,OASA,303,19,284
285822,W00003108,W00003108,Output Areas and Small Areas,OASA,279,123,156
285823,W00003109,W00003109,Output Areas and Small Areas,OASA,302,129,173
285824,W00003110,W00003110,Output Areas and Small Areas,OASA,184,80,104
285825,W00003111,W00003111,Output Areas and Small Areas,OASA,238,78,160
285826,W00003112,W00003112,Output Areas and Small Areas,OASA,250,78,172
285827,W00003113,W00003113,Output Areas and Small Areas,OASA,171,86,85
285828,W00003114,W00003114,Output Areas and Small Areas,OASA,248,134,114
285829,W00003115,W00003115,Output Areas and Small Areas,OASA,312,153,159
285830,W00003116,W00003116,Output Areas and Small Areas,OASA,299,154,145
285831,W00003117,W00003117,Output Areas and Small Areas,OASA,238,88,150
285832,W00003118,W00003118,Output Areas and Small Areas,OASA,174,67,107
285833,W00003119,W00003119,Output Areas and Small Areas,OASA,355,104,251
285834,W00003120,W00003120,Output Areas and Small Areas,OASA,282,135,147
285835,W00003121,W00003121,Output Areas and Small Areas,OASA,236,104,132
285836,W00003122,W00003122,Output Areas and Small Areas,OASA,220,98,122
285837,W00003123,W00003123,Output Areas and Small Areas,OASA,267,19,248
285838,W00003124,W00003124,Output Areas and Small Areas,OASA,266,23,243
285839,W00003125,W00003125,Output Areas and Small Areas,OASA,278,19,259
285840,W00003126,W00003126,Output Areas and Small Areas,OASA,287,23,264
285841,W00003127,W00003127,Output Areas and Small Areas,OASA,282,20,262
285842,W00003128,W00003128,Output Areas and Small Areas,OASA,315,22,293
285843,W00003129,W00003129,Output Areas and Small Areas,OASA,320,72,248
285844,W00003130,W00003130,Output Areas and Small Areas,OASA,253,31,222
285845,W00003131,W00003131,Output Areas and Small Areas,OASA,284,32,252
285846,W00003132,W00003132,Output Areas and Small Areas,OASA,212,19,193
285847,W00003133,W00003133,Output Areas and Small Areas,OASA,134,9,125
285848,W00003134,W00003134,Output Areas and Small Areas,OASA,240,17,223
285849,W00003135,W00003135,Output Areas and Small Areas,OASA,259,39,220
285850,W00003136,W00003136,Output Areas and Small Areas,OASA,259,37,222
285851,W00003137,W00003137,Output Areas and Small Areas,OASA,229,19,210
285852,W00003138,W00003138,Output Areas and Small Areas,OASA,284,36,248
285853,W00003139,W00003139,Output Areas and Small Areas,OASA,274,18,256
285854,W00003140,W00003140,Output Areas and Small Areas,OASA,205,21,184
285855,W00003141,W00003141,Output Areas and Small Areas,OASA,222,8,214
285856,W00003142,W00003142,Output Areas and Small Areas,OASA,227,15,212
285857,W00003143,W00003143,Output Areas and Small Areas,OASA,291,17,274
285858,W00003144,W00003144,Output Areas and Small Areas,OASA,199,8,191
285859,W00003145,W00003145,Output Areas and Small Areas,OASA,332,19,313
285860,W00003146,W00003146,Output Areas and Small Areas,OASA,221,12,209
285861,W00003147,W00003147,Output Areas and Small Areas,OASA,208,13,195
285862,W00003148,W00003148,Output Areas and Small Areas,OASA,250,5,245
285863,W00003149,W00003149,Output Areas and Small Areas,OASA,216,20,196
285864,W00003150,W00003150,Output Areas and Small Areas,OASA,277,23,254
285865,W00003151,W00003151,Output Areas and Small Areas,OASA,144,8,136
285866,W00003152,W00003152,Output Areas and Small Areas,OASA,133,8,125
285867,W00003153,W00003153,Output Areas and Small Areas,OASA,213,8,205
285868,W00003154,W00003154,Output Areas and Small Areas,OASA,178,12,166
285869,W00003155,W00003155,Output Areas and Small Areas,OASA,254,18,236
285870,W00003156,W00003156,Output Areas and Small Areas,OASA,225,5,220
285871,W00003157,W00003157,Output Areas and Small Areas,OASA,266,10,256
285872,W00003158,W00003158,Output Areas and Small Areas,OASA,221,9,212
285873,W00003159,W00003159,Output Areas and Small Areas,OASA,231,9,222
285874,W00003160,W00003160,Output Areas and Small Areas,OASA,249,15,234
285875,W00003161,W00003161,Output Areas and Small Areas,OASA,216,8,208
285876,W00003162,W00003162,Output Areas and Small Areas,OASA,233,16,217
285877,W00003163,W00003163,Output Areas and Small Areas,OASA,230,15,215
285878,W00003164,W00003164,Output Areas and Small Areas,OASA,312,18,294
285879,W00003165,W00003165,Output Areas and Small Areas,OASA,283,16,267
285880,W00003166,W00003166,Output Areas and Small Areas,OASA,239,12,227
285881,W00003167,W00003167,Output Areas and Small Areas,OASA,315,16,299
285882,W00003168,W00003168,Output Areas and Small Areas,OASA,233,26,207
285883,W00003169,W00003169,Output Areas and Small Areas,OASA,243,15,228
285884,W00003170,W00003170,Output Areas and Small Areas,OASA,228,9,219
285885,W00003171,W00003171,Output Areas and Small Areas,OASA,105,4,101
285886,W00003172,W00003172,Output Areas and Small Areas,OASA,418,24,394
285887,W00003173,W00003173,Output Areas and Small Areas,OASA,213,13,200
285888,W00003174,W00003174,Output Areas and Small Areas,OASA,365,19,346
285889,W00003175,W00003175,Output Areas and Small Areas,OASA,387,32,355
285890,W00003176,W00003176,Output Areas and Small Areas,OASA,366,26,340
285891,W00003177,W00003177,Output Areas and Small Areas,OASA,252,12,240
285892,W00003178,W00003178,Output Areas and Small Areas,OASA,230,8,222
285893,W00003179,W00003179,Output Areas and Small Areas,OASA,171,6,165
285894,W00003180,W00003180,Output Areas and Small Areas,OASA,246,5,241
285895,W00003181,W00003181,Output Areas and Small Areas,OASA,215,12,203
285896,W00003182,W00003182,Output Areas and Small Areas,OASA,266,17,249
285897,W00003183,W00003183,Output Areas and Small Areas,OASA,205,12,193
285898,W00003184,W00003184,Output Areas and Small Areas,OASA,266,17,249
285899,W00003185,W00003185,Output Areas and Small Areas,OASA,216,9,207
285900,W00003186,W00003186,Output Areas and Small Areas,OASA,190,12,178
285901,W00003187,W00003187,Output Areas and Small Areas,OASA,243,47,196
285902,W00003188,W00003188,Output Areas and Small Areas,OASA,212,32,180
285903,W00003189,W00003189,Output Areas and Small Areas,OASA,177,37,140
285904,W00003190,W00003190,Output Areas and Small Areas,OASA,218,43,175
285905,W00003191,W00003191,Output Areas and Small Areas,OASA,208,31,177
285906,W00003192,W00003192,Output Areas and Small Areas,OASA,291,45,246
285907,W00003193,W00003193,Output Areas and Small Areas,OASA,240,37,203
285908,W00003194,W00003194,Output Areas and Small Areas,OASA,175,26,149
285909,W00003195,W00003195,Output Areas and Small Areas,OASA,291,44,247
285910,W00003196,W00003196,Output Areas and Small Areas,OASA,266,38,228
285911,W00003197,W00003197,Output Areas and Small Areas,OASA,272,24,248
285912,W00003198,W00003198,Output Areas and Small Areas,OASA,247,33,214
285913,W00003199,W00003199,Output Areas and Small Areas,OASA,252,89,163
285914,W00003200,W00003200,Output Areas and Small Areas,OASA,232,75,157
285915,W00003201,W00003201,Output Areas and Small Areas,OASA,229,82,147
285916,W00003202,W00003202,Output Areas and Small Areas,OASA,265,134,131
285917,W00003203,W00003203,Output Areas and Small Areas,OASA,278,20,258
285918,W00003204,W00003204,Output Areas and Small Areas,OASA,265,20,245
285919,W00003205,W00003205,Output Areas and Small Areas,OASA,288,24,264
285920,W00003206,W00003206,Output Areas and Small Areas,OASA,235,15,220
285921,W00003207,W00003207,Output Areas and Small Areas,OASA,226,13,213
285922,W00003208,W00003208,Output Areas and Small Areas,OASA,254,11,243
285923,W00003209,W00003209,Output Areas and Small Areas,OASA,295,18,277
285924,W00003210,W00003210,Output Areas and Small Areas,OASA,278,10,268
285925,W00003211,W00003211,Output Areas and Small Areas,OASA,209,15,194
285926,W00003212,W00003212,Output Areas and Small Areas,OASA,260,24,236
285927,W00003213,W00003213,Output Areas and Small Areas,OASA,210,8,202
285928,W00003214,W00003214,Output Areas and Small Areas,OASA,264,16,248
285929,W00003215,W00003215,Output Areas and Small Areas,OASA,213,11,202
285930,W00003216,W00003216,Output Areas and Small Areas,OASA,283,17,266
285931,W00003217,W00003217,Output Areas and Small Areas,OASA,203,6,197
285932,W00003218,W00003218,Output Areas and Small Areas,OASA,182,15,167
285933,W00003219,W00003219,Output Areas and Small Areas,OASA,199,10,189
285934,W00003220,W00003220,Output Areas and Small Areas,OASA,229,17,212
285935,W00003221,W00003221,Output Areas and Small Areas,OASA,236,10,226
285936,W00003222,W00003222,Output Areas and Small Areas,OASA,310,27,283
285937,W00003223,W00003223,Output Areas and Small Areas,OASA,204,8,196
285938,W00003224,W00003224,Output Areas and Small Areas,OASA,210,5,205
285939,W00003225,W00003225,Output Areas and Small Areas,OASA,231,13,218
285940,W00003226,W00003226,Output Areas and Small Areas,OASA,285,24,261
285941,W00003227,W00003227,Output Areas and Small Areas,OASA,232,18,214
285942,W00003228,W00003228,Output Areas and Small Areas,OASA,262,14,248
285943,W00003229,W00003229,Output Areas and Small Areas,OASA,279,12,267
285944,W00003230,W00003230,Output Areas and Small Areas,OASA,291,20,271
285945,W00003231,W00003231,Output Areas and Small Areas,OASA,236,11,225
285946,W00003232,W00003232,Output Areas and Small Areas,OASA,240,20,220
285947,W00003233,W00003233,Output Areas and Small Areas,OASA,220,13,207
285948,W00003234,W00003234,Output Areas and Small Areas,OASA,234,9,225
285949,W00003235,W00003235,Output Areas and Small Areas,OASA,307,19,288
285950,W00003236,W00003236,Output Areas and Small Areas,OASA,222,11,211
285951,W00003237,W00003237,Output Areas and Small Areas,OASA,271,14,257
285952,W00003238,W00003238,Output Areas and Small Areas,OASA,218,15,203
285953,W00003239,W00003239,Output Areas and Small Areas,OASA,294,11,283
285954,W00003240,W00003240,Output Areas and Small Areas,OASA,240,14,226
285955,W00003241,W00003241,Output Areas and Small Areas,OASA,232,11,221
285956,W00003242,W00003242,Output Areas and Small Areas,OASA,377,18,359
285957,W00003243,W00003243,Output Areas and Small Areas,OASA,268,8,260
285958,W00003244,W00003244,Output Areas and Small Areas,OASA,242,15,227
285959,W00003245,W00003245,Output Areas and Small Areas,OASA,212,12,200
285960,W00003246,W00003246,Output Areas and Small Areas,OASA,278,23,255
285961,W00003247,W00003247,Output Areas and Small Areas,OASA,256,18,238
285962,W00003248,W00003248,Output Areas and Small Areas,OASA,268,13,255
285963,W00003249,W00003249,Output Areas and Small Areas,OASA,208,13,195
285964,W00003250,W00003250,Output Areas and Small Areas,OASA,256,14,242
285965,W00003251,W00003251,Output Areas and Small Areas,OASA,257,13,244
285966,W00003252,W00003252,Output Areas and Small Areas,OASA,220,9,211
285967,W00003253,W00003253,Output Areas and Small Areas,OASA,250,14,236
285968,W00003254,W00003254,Output Areas and Small Areas,OASA,261,15,246
285969,W00003255,W00003255,Output Areas and Small Areas,OASA,302,19,283
285970,W00003256,W00003256,Output Areas and Small Areas,OASA,249,16,233
285971,W00003257,W00003257,Output Areas and Small Areas,OASA,249,12,237
285972,W00003258,W00003258,Output Areas and Small Areas,OASA,287,11,276
285973,W00003259,W00003259,Output Areas and Small Areas,OASA,260,33,227
285974,W00003260,W00003260,Output Areas and Small Areas,OASA,256,15,241
285975,W00003261,W00003261,Output Areas and Small Areas,OASA,218,10,208
285976,W00003262,W00003262,Output Areas and Small Areas,OASA,258,11,247
285977,W00003263,W00003263,Output Areas and Small Areas,OASA,203,9,194
285978,W00003264,W00003264,Output Areas and Small Areas,OASA,219,10,209
285979,W00003265,W00003265,Output Areas and Small Areas,OASA,279,25,254
285980,W00003266,W00003266,Output Areas and Small Areas,OASA,242,20,222
285981,W00003267,W00003267,Output Areas and Small Areas,OASA,246,26,220
285982,W00003268,W00003268,Output Areas and Small Areas,OASA,321,25,296
285983,W00003269,W00003269,Output Areas and Small Areas,OASA,262,16,246
285984,W00003270,W00003270,Output Areas and Small Areas,OASA,250,16,234
285985,W00003271,W00003271,Output Areas and Small Areas,OASA,247,18,229
285986,W00003272,W00003272,Output Areas and Small Areas,OASA,244,18,226
285987,W00003273,W00003273,Output Areas and Small Areas,OASA,218,26,192
285988,W00003274,W00003274,Output Areas and Small Areas,OASA,265,22,243
285989,W00003275,W00003275,Output Areas and Small Areas,OASA,503,34,469
285990,W00003276,W00003276,Output Areas and Small Areas,OASA,239,23,216
285991,W00003277,W00003277,Output Areas and Small Areas,OASA,152,31,121
285992,W00003278,W00003278,Output Areas and Small Areas,OASA,284,42,242
285993,W00003279,W00003279,Output Areas and Small Areas,OASA,241,32,209
285994,W00003280,W00003280,Output Areas and Small Areas,OASA,262,36,226
285995,W00003281,W00003281,Output Areas and Small Areas,OASA,179,22,157
285996,W00003282,W00003282,Output Areas and Small Areas,OASA,316,58,258
285997,W00003283,W00003283,Output Areas and Small Areas,OASA,235,72,163
285998,W00003284,W00003284,Output Areas and Small Areas,OASA,244,62,182
285999,W00003285,W00003285,Output Areas and Small Areas,OASA,246,59,187
286000,W00003286,W00003286,Output Areas and Small Areas,OASA,222,70,152
286001,W00003287,W00003287,Output Areas and Small Areas,OASA,364,92,272
286002,W00003288,W00003288,Output Areas and Small Areas,OASA,238,58,180
286003,W00003289,W00003289,Output Areas and Small Areas,OASA,235,89,146
286004,W00003290,W00003290,Output Areas and Small Areas,OASA,215,109,106
286005,W00003291,W00003291,Output Areas and Small Areas,OASA,287,133,154
286006,W00003292,W00003292,Output Areas and Small Areas,OASA,265,101,164
286007,W00003293,W00003293,Output Areas and Small Areas,OASA,216,78,138
286008,W00003294,W00003294,Output Areas and Small Areas,OASA,219,96,123
286009,W00003295,W00003295,Output Areas and Small Areas,OASA,198,71,127
286010,W00003296,W00003296,Output Areas and Small Areas,OASA,229,77,152
286011,W00003297,W00003297,Output Areas and Small Areas,OASA,196,11,185
286012,W00003298,W00003298,Output Areas and Small Areas,OASA,325,17,308
286013,W00003299,W00003299,Output Areas and Small Areas,OASA,258,13,245
286014,W00003300,W00003300,Output Areas and Small Areas,OASA,202,15,187
286015,W00003301,W00003301,Output Areas and Small Areas,OASA,210,8,202
286016,W00003302,W00003302,Output Areas and Small Areas,OASA,318,20,298
286017,W00003303,W00003303,Output Areas and Small Areas,OASA,211,16,195
286018,W00003304,W00003304,Output Areas and Small Areas,OASA,164,13,151
286019,W00003305,W00003305,Output Areas and Small Areas,OASA,151,14,137
286020,W00003306,W00003306,Output Areas and Small Areas,OASA,222,12,210
286021,W00003307,W00003307,Output Areas and Small Areas,OASA,102,11,91
286022,W00003308,W00003308,Output Areas and Small Areas,OASA,166,13,153
286023,W00003309,W00003309,Output Areas and Small Areas,OASA,170,12,158
286024,W00003310,W00003310,Output Areas and Small Areas,OASA,206,12,194
286025,W00003311,W00003311,Output Areas and Small Areas,OASA,111,7,104
286026,W00003312,W00003312,Output Areas and Small Areas,OASA,225,13,212
286027,W00003313,W00003313,Output Areas and Small Areas,OASA,202,11,191
286028,W00003314,W00003314,Output Areas and Small Areas,OASA,388,142,246
286029,W00003315,W00003315,Output Areas and Small Areas,OASA,259,79,180
286030,W00003316,W00003316,Output Areas and Small Areas,OASA,267,77,190
286031,W00003317,W00003317,Output Areas and Small Areas,OASA,277,67,210
286032,W00003318,W00003318,Output Areas and Small Areas,OASA,317,63,254
286033,W00003319,W00003319,Output Areas and Small Areas,OASA,545,57,488
286034,W00003320,W00003320,Output Areas and Small Areas,OASA,204,56,148
286035,W00003321,W00003321,Output Areas and Small Areas,OASA,180,49,131
286036,W00003322,W00003322,Output Areas and Small Areas,OASA,120,41,79
286037,W00003323,W00003323,Output Areas and Small Areas,OASA,207,47,160
286038,W00003324,W00003324,Output Areas and Small Areas,OASA,169,8,161
286039,W00003325,W00003325,Output Areas and Small Areas,OASA,250,21,229
286040,W00003326,W00003326,Output Areas and Small Areas,OASA,254,19,235
286041,W00003327,W00003327,Output Areas and Small Areas,OASA,200,8,192
286042,W00003328,W00003328,Output Areas and Small Areas,OASA,216,22,194
286043,W00003329,W00003329,Output Areas and Small Areas,OASA,180,12,168
286044,W00003330,W00003330,Output Areas and Small Areas,OASA,251,30,221
286045,W00003331,W00003331,Output Areas and Small Areas,OASA,247,24,223
286046,W00003332,W00003332,Output Areas and Small Areas,OASA,170,9,161
286047,W00003333,W00003333,Output Areas and Small Areas,OASA,223,7,216
286048,W00003334,W00003334,Output Areas and Small Areas,OASA,153,10,143
286049,W00003335,W00003335,Output Areas and Small Areas,OASA,206,14,192
286050,W00003336,W00003336,Output Areas and Small Areas,OASA,290,16,274
286051,W00003337,W00003337,Output Areas and Small Areas,OASA,163,10,153
286052,W00003338,W00003338,Output Areas and Small Areas,OASA,199,16,183
286053,W00003339,W00003339,Output Areas and Small Areas,OASA,221,9,212
286054,W00003340,W00003340,Output Areas and Small Areas,OASA,188,9,179
286055,W00003341,W00003341,Output Areas and Small Areas,OASA,203,15,188
286056,W00003342,W00003342,Output Areas and Small Areas,OASA,193,13,180
286057,W00003343,W00003343,Output Areas and Small Areas,OASA,247,25,222
286058,W00003344,W00003344,Output Areas and Small Areas,OASA,210,14,196
286059,W00003345,W00003345,Output Areas and Small Areas,OASA,243,21,222
286060,W00003346,W00003346,Output Areas and Small Areas,OASA,253,24,229
286061,W00003347,W00003347,Output Areas and Small Areas,OASA,300,32,268
286062,W00003348,W00003348,Output Areas and Small Areas,OASA,317,101,216
286063,W00003349,W00003349,Output Areas and Small Areas,OASA,222,38,184
286064,W00003350,W00003350,Output Areas and Small Areas,OASA,191,35,156
286065,W00003351,W00003351,Output Areas and Small Areas,OASA,294,57,237
286066,W00003352,W00003352,Output Areas and Small Areas,OASA,328,57,271
286067,W00003353,W00003353,Output Areas and Small Areas,OASA,252,41,211
286068,W00003354,W00003354,Output Areas and Small Areas,OASA,316,142,174
286069,W00003355,W00003355,Output Areas and Small Areas,OASA,294,186,108
286070,W00003356,W00003356,Output Areas and Small Areas,OASA,238,140,98
286071,W00003357,W00003357,Output Areas and Small Areas,OASA,264,121,143
286072,W00003358,W00003358,Output Areas and Small Areas,OASA,208,100,108
286073,W00003359,W00003359,Output Areas and Small Areas,OASA,307,148,159
286074,W00003360,W00003360,Output Areas and Small Areas,OASA,280,141,139
286075,W00003361,W00003361,Output Areas and Small Areas,OASA,253,112,141
286076,W00003362,W00003362,Output Areas and Small Areas,OASA,185,84,101
286077,W00003363,W00003363,Output Areas and Small Areas,OASA,163,52,111
286078,W00003364,W00003364,Output Areas and Small Areas,OASA,252,123,129
286079,W00003365,W00003365,Output Areas and Small Areas,OASA,207,101,106
286080,W00003366,W00003366,Output Areas and Small Areas,OASA,227,127,100
286081,W00003367,W00003367,Output Areas and Small Areas,OASA,216,104,112
286082,W00003368,W00003368,Output Areas and Small Areas,OASA,176,87,89
286083,W00003369,W00003369,Output Areas and Small Areas,OASA,186,97,89
286084,W00003370,W00003370,Output Areas and Small Areas,OASA,269,159,110
286085,W00003372,W00003372,Output Areas and Small Areas,OASA,349,185,164
286086,W00003373,W00003373,Output Areas and Small Areas,OASA,179,72,107
286087,W00003374,W00003374,Output Areas and Small Areas,OASA,224,92,132
286088,W00003375,W00003375,Output Areas and Small Areas,OASA,237,136,101
286089,W00003376,W00003376,Output Areas and Small Areas,OASA,222,110,112
286090,W00003377,W00003377,Output Areas and Small Areas,OASA,226,51,175
286091,W00003378,W00003378,Output Areas and Small Areas,OASA,236,35,201
286092,W00003379,W00003379,Output Areas and Small Areas,OASA,214,24,190
286093,W00003380,W00003380,Output Areas and Small Areas,OASA,263,47,216
286094,W00003381,W00003381,Output Areas and Small Areas,OASA,156,40,116
286095,W00003382,W00003382,Output Areas and Small Areas,OASA,250,59,191
286096,W00003383,W00003383,Output Areas and Small Areas,OASA,234,64,170
286097,W00003384,W00003384,Output Areas and Small Areas,OASA,339,82,257
286098,W00003385,W00003385,Output Areas and Small Areas,OASA,273,68,205
286099,W00003386,W00003386,Output Areas and Small Areas,OASA,210,36,174
286100,W00003387,W00003387,Output Areas and Small Areas,OASA,268,44,224
286101,W00003388,W00003388,Output Areas and Small Areas,OASA,210,35,175
286102,W00003389,W00003389,Output Areas and Small Areas,OASA,243,27,216
286103,W00003390,W00003390,Output Areas and Small Areas,OASA,263,59,204
286104,W00003391,W00003391,Output Areas and Small Areas,OASA,230,51,179
286105,W00003392,W00003392,Output Areas and Small Areas,OASA,308,71,237
286106,W00003393,W00003393,Output Areas and Small Areas,OASA,260,41,219
286107,W00003394,W00003394,Output Areas and Small Areas,OASA,234,60,174
286108,W00003395,W00003395,Output Areas and Small Areas,OASA,258,78,180
286109,W00003396,W00003396,Output Areas and Small Areas,OASA,274,83,191
286110,W00003397,W00003397,Output Areas and Small Areas,OASA,249,57,192
286111,W00003398,W00003398,Output Areas and Small Areas,OASA,240,46,194
286112,W00003399,W00003399,Output Areas and Small Areas,OASA,244,62,182
286113,W00003400,W00003400,Output Areas and Small Areas,OASA,258,75,183
286114,W00003401,W00003401,Output Areas and Small Areas,OASA,258,70,188
286115,W00003402,W00003402,Output Areas and Small Areas,OASA,228,55,173
286116,W00003403,W00003403,Output Areas and Small Areas,OASA,234,66,168
286117,W00003404,W00003404,Output Areas and Small Areas,OASA,216,77,139
286118,W00003405,W00003405,Output Areas and Small Areas,OASA,285,77,208
286119,W00003406,W00003406,Output Areas and Small Areas,OASA,217,61,156
286120,W00003407,W00003407,Output Areas and Small Areas,OASA,229,61,168
286121,W00003408,W00003408,Output Areas and Small Areas,OASA,189,51,138
286122,W00003409,W00003409,Output Areas and Small Areas,OASA,245,114,131
286123,W00003410,W00003410,Output Areas and Small Areas,OASA,214,78,136
286124,W00003411,W00003411,Output Areas and Small Areas,OASA,203,78,125
286125,W00003412,W00003412,Output Areas and Small Areas,OASA,283,73,210
286126,W00003413,W00003413,Output Areas and Small Areas,OASA,250,54,196
286127,W00003414,W00003414,Output Areas and Small Areas,OASA,256,88,168
286128,W00003415,W00003415,Output Areas and Small Areas,OASA,274,88,186
286129,W00003416,W00003416,Output Areas and Small Areas,OASA,235,66,169
286130,W00003418,W00003418,Output Areas and Small Areas,OASA,238,49,189
286131,W00003419,W00003419,Output Areas and Small Areas,OASA,264,97,167
286132,W00003421,W00003421,Output Areas and Small Areas,OASA,270,77,193
286133,W00003422,W00003422,Output Areas and Small Areas,OASA,242,76,166
286134,W00003423,W00003423,Output Areas and Small Areas,OASA,470,128,342
286135,W00003424,W00003424,Output Areas and Small Areas,OASA,185,92,93
286136,W00003425,W00003425,Output Areas and Small Areas,OASA,279,113,166
286137,W00003426,W00003426,Output Areas and Small Areas,OASA,251,82,169
286138,W00003427,W00003427,Output Areas and Small Areas,OASA,251,112,139
286139,W00003428,W00003428,Output Areas and Small Areas,OASA,179,46,133
286140,W00003429,W00003429,Output Areas and Small Areas,OASA,199,66,133
286141,W00003430,W00003430,Output Areas and Small Areas,OASA,212,68,144
286142,W00003431,W00003431,Output Areas and Small Areas,OASA,237,83,154
286143,W00003432,W00003432,Output Areas and Small Areas,OASA,255,74,181
286144,W00003433,W00003433,Output Areas and Small Areas,OASA,225,62,163
286145,W00003434,W00003434,Output Areas and Small Areas,OASA,221,60,161
286146,W00003435,W00003435,Output Areas and Small Areas,OASA,243,105,138
286147,W00003436,W00003436,Output Areas and Small Areas,OASA,231,91,140
286148,W00003437,W00003437,Output Areas and Small Areas,OASA,200,54,146
286149,W00003438,W00003438,Output Areas and Small Areas,OASA,245,104,141
286150,W00003439,W00003439,Output Areas and Small Areas,OASA,203,58,145
286151,W00003440,W00003440,Output Areas and Small Areas,OASA,267,131,136
286152,W00003441,W00003441,Output Areas and Small Areas,OASA,277,133,144
286153,W00003442,W00003442,Output Areas and Small Areas,OASA,204,77,127
286154,W00003443,W00003443,Output Areas and Small Areas,OASA,246,96,150
286155,W00003444,W00003444,Output Areas and Small Areas,OASA,266,105,161
286156,W00003445,W00003445,Output Areas and Small Areas,OASA,249,91,158
286157,W00003446,W00003446,Output Areas and Small Areas,OASA,228,73,155
286158,W00003447,W00003447,Output Areas and Small Areas,OASA,177,71,106
286159,W00003448,W00003448,Output Areas and Small Areas,OASA,191,59,132
286160,W00003449,W00003449,Output Areas and Small Areas,OASA,186,64,122
286161,W00003450,W00003450,Output Areas and Small Areas,OASA,272,98,174
286162,W00003451,W00003451,Output Areas and Small Areas,OASA,279,64,215
286163,W00003452,W00003452,Output Areas and Small Areas,OASA,295,115,180
286164,W00003453,W00003453,Output Areas and Small Areas,OASA,204,90,114
286165,W00003454,W00003454,Output Areas and Small Areas,OASA,270,130,140
286166,W00003455,W00003455,Output Areas and Small Areas,OASA,246,114,132
286167,W00003456,W00003456,Output Areas and Small Areas,OASA,259,87,172
286168,W00003457,W00003457,Output Areas and Small Areas,OASA,335,113,222
286169,W00003458,W00003458,Output Areas and Small Areas,OASA,149,77,72
286170,W00003459,W00003459,Output Areas and Small Areas,OASA,244,85,159
286171,W00003460,W00003460,Output Areas and Small Areas,OASA,283,111,172
286172,W00003461,W00003461,Output Areas and Small Areas,OASA,345,156,189
286173,W00003463,W00003463,Output Areas and Small Areas,OASA,235,117,118
286174,W00003464,W00003464,Output Areas and Small Areas,OASA,218,62,156
286175,W00003465,W00003465,Output Areas and Small Areas,OASA,294,121,173
286176,W00003466,W00003466,Output Areas and Small Areas,OASA,211,57,154
286177,W00003467,W00003467,Output Areas and Small Areas,OASA,259,86,173
286178,W00003468,W00003468,Output Areas and Small Areas,OASA,267,100,167
286179,W00003469,W00003469,Output Areas and Small Areas,OASA,233,71,162
286180,W00003470,W00003470,Output Areas and Small Areas,OASA,250,85,165
286181,W00003471,W00003471,Output Areas and Small Areas,OASA,181,58,123
286182,W00003472,W00003472,Output Areas and Small Areas,OASA,205,93,112
286183,W00003473,W00003473,Output Areas and Small Areas,OASA,246,105,141
286184,W00003474,W00003474,Output Areas and Small Areas,OASA,287,156,131
286185,W00003475,W00003475,Output Areas and Small Areas,OASA,271,148,123
286186,W00003476,W00003476,Output Areas and Small Areas,OASA,402,182,220
286187,W00003477,W00003477,Output Areas and Small Areas,OASA,221,99,122
286188,W00003478,W00003478,Output Areas and Small Areas,OASA,183,81,102
286189,W00003479,W00003479,Output Areas and Small Areas,OASA,190,59,131
286190,W00003480,W00003480,Output Areas and Small Areas,OASA,239,89,150
286191,W00003481,W00003481,Output Areas and Small Areas,OASA,189,74,115
286192,W00003482,W00003482,Output Areas and Small Areas,OASA,241,130,111
286193,W00003483,W00003483,Output Areas and Small Areas,OASA,258,134,124
286194,W00003484,W00003484,Output Areas and Small Areas,OASA,229,124,105
286195,W00003485,W00003485,Output Areas and Small Areas,OASA,325,165,160
286196,W00003486,W00003486,Output Areas and Small Areas,OASA,295,126,169
286197,W00003487,W00003487,Output Areas and Small Areas,OASA,252,127,125
286198,W00003488,W00003488,Output Areas and Small Areas,OASA,300,128,172
286199,W00003489,W00003489,Output Areas and Small Areas,OASA,311,172,139
286200,W00003490,W00003490,Output Areas and Small Areas,OASA,297,154,143
286201,W00003491,W00003491,Output Areas and Small Areas,OASA,276,165,111
286202,W00003492,W00003492,Output Areas and Small Areas,OASA,237,89,148
286203,W00003493,W00003493,Output Areas and Small Areas,OASA,283,123,160
286204,W00003494,W00003494,Output Areas and Small Areas,OASA,278,124,154
286205,W00003495,W00003495,Output Areas and Small Areas,OASA,388,178,210
286206,W00003496,W00003496,Output Areas and Small Areas,OASA,203,89,114
286207,W00003497,W00003497,Output Areas and Small Areas,OASA,248,60,188
286208,W00003498,W00003498,Output Areas and Small Areas,OASA,199,58,141
286209,W00003499,W00003499,Output Areas and Small Areas,OASA,338,94,244
286210,W00003500,W00003500,Output Areas and Small Areas,OASA,230,54,176
286211,W00003501,W00003501,Output Areas and Small Areas,OASA,302,53,249
286212,W00003502,W00003502,Output Areas and Small Areas,OASA,247,61,186
286213,W00003503,W00003503,Output Areas and Small Areas,OASA,365,122,243
286214,W00003504,W00003504,Output Areas and Small Areas,OASA,265,83,182
286215,W00003505,W00003505,Output Areas and Small Areas,OASA,243,60,183
286216,W00003506,W00003506,Output Areas and Small Areas,OASA,192,48,144
286217,W00003507,W00003507,Output Areas and Small Areas,OASA,229,56,173
286218,W00003508,W00003508,Output Areas and Small Areas,OASA,221,46,175
286219,W00003509,W00003509,Output Areas and Small Areas,OASA,212,62,150
286220,W00003510,W00003510,Output Areas and Small Areas,OASA,245,72,173
286221,W00003511,W00003511,Output Areas and Small Areas,OASA,277,85,192
286222,W00003512,W00003512,Output Areas and Small Areas,OASA,238,61,177
286223,W00003513,W00003513,Output Areas and Small Areas,OASA,268,58,210
286224,W00003514,W00003514,Output Areas and Small Areas,OASA,259,56,203
286225,W00003515,W00003515,Output Areas and Small Areas,OASA,209,55,154
286226,W00003516,W00003516,Output Areas and Small Areas,OASA,238,57,181
286227,W00003517,W00003517,Output Areas and Small Areas,OASA,286,93,193
286228,W00003518,W00003518,Output Areas and Small Areas,OASA,218,79,139
286229,W00003519,W00003519,Output Areas and Small Areas,OASA,156,37,119
286230,W00003520,W00003520,Output Areas and Small Areas,OASA,230,55,175
286231,W00003521,W00003521,Output Areas and Small Areas,OASA,230,41,189
286232,W00003522,W00003522,Output Areas and Small Areas,OASA,202,32,170
286233,W00003523,W00003523,Output Areas and Small Areas,OASA,209,52,157
286234,W00003524,W00003524,Output Areas and Small Areas,OASA,287,94,193
286235,W00003525,W00003525,Output Areas and Small Areas,OASA,275,84,191
286236,W00003526,W00003526,Output Areas and Small Areas,OASA,277,164,113
286237,W00003527,W00003527,Output Areas and Small Areas,OASA,274,162,112
286238,W00003528,W00003528,Output Areas and Small Areas,OASA,329,160,169
286239,W00003529,W00003529,Output Areas and Small Areas,OASA,266,161,105
286240,W00003530,W00003530,Output Areas and Small Areas,OASA,254,131,123
286241,W00003531,W00003531,Output Areas and Small Areas,OASA,228,134,94
286242,W00003532,W00003532,Output Areas and Small Areas,OASA,93,33,60
286243,W00003533,W00003533,Output Areas and Small Areas,OASA,239,147,92
286244,W00003534,W00003534,Output Areas and Small Areas,OASA,224,108,116
286245,W00003535,W00003535,Output Areas and Small Areas,OASA,231,127,104
286246,W00003536,W00003536,Output Areas and Small Areas,OASA,224,120,104
286247,W00003537,W00003537,Output Areas and Small Areas,OASA,263,156,107
286248,W00003538,W00003538,Output Areas and Small Areas,OASA,263,151,112
286249,W00003539,W00003539,Output Areas and Small Areas,OASA,292,161,131
286250,W00003540,W00003540,Output Areas and Small Areas,OASA,190,123,67
286251,W00003541,W00003541,Output Areas and Small Areas,OASA,230,35,195
286252,W00003542,W00003542,Output Areas and Small Areas,OASA,279,63,216
286253,W00003543,W00003543,Output Areas and Small Areas,OASA,248,35,213
286254,W00003544,W00003544,Output Areas and Small Areas,OASA,217,40,177
286255,W00003545,W00003545,Output Areas and Small Areas,OASA,184,23,161
286256,W00003546,W00003546,Output Areas and Small Areas,OASA,242,36,206
286257,W00003547,W00003547,Output Areas and Small Areas,OASA,259,42,217
286258,W00003548,W00003548,Output Areas and Small Areas,OASA,215,29,186
286259,W00003549,W00003549,Output Areas and Small Areas,OASA,203,30,173
286260,W00003550,W00003550,Output Areas and Small Areas,OASA,252,37,215
286261,W00003552,W00003552,Output Areas and Small Areas,OASA,266,24,242
286262,W00003553,W00003553,Output Areas and Small Areas,OASA,224,34,190
286263,W00003554,W00003554,Output Areas and Small Areas,OASA,208,26,182
286264,W00003555,W00003555,Output Areas and Small Areas,OASA,204,35,169
286265,W00003556,W00003556,Output Areas and Small Areas,OASA,218,45,173
286266,W00003557,W00003557,Output Areas and Small Areas,OASA,205,52,153
286267,W00003558,W00003558,Output Areas and Small Areas,OASA,137,22,115
286268,W00003559,W00003559,Output Areas and Small Areas,OASA,257,106,151
286269,W00003560,W00003560,Output Areas and Small Areas,OASA,246,158,88
286270,W00003561,W00003561,Output Areas and Small Areas,OASA,271,183,88
286271,W00003562,W00003562,Output Areas and Small Areas,OASA,225,104,121
286272,W00003563,W00003563,Output Areas and Small Areas,OASA,255,108,147
286273,W00003564,W00003564,Output Areas and Small Areas,OASA,264,170,94
286274,W00003565,W00003565,Output Areas and Small Areas,OASA,274,167,107
286275,W00003566,W00003566,Output Areas and Small Areas,OASA,219,151,68
286276,W00003567,W00003567,Output Areas and Small Areas,OASA,358,220,138
286277,W00003568,W00003568,Output Areas and Small Areas,OASA,276,193,83
286278,W00003569,W00003569,Output Areas and Small Areas,OASA,345,187,158
286279,W00003570,W00003570,Output Areas and Small Areas,OASA,313,201,112
286280,W00003571,W00003571,Output Areas and Small Areas,OASA,262,188,74
286281,W00003572,W00003572,Output Areas and Small Areas,OASA,183,112,71
286282,W00003573,W00003573,Output Areas and Small Areas,OASA,357,198,159
286283,W00003574,W00003574,Output Areas and Small Areas,OASA,359,247,112
286284,W00003575,W00003575,Output Areas and Small Areas,OASA,212,106,106
286285,W00003576,W00003576,Output Areas and Small Areas,OASA,242,109,133
286286,W00003577,W00003577,Output Areas and Small Areas,OASA,277,175,102
286287,W00003578,W00003578,Output Areas and Small Areas,OASA,271,122,149
286288,W00003579,W00003579,Output Areas and Small Areas,OASA,245,132,113
286289,W00003580,W00003580,Output Areas and Small Areas,OASA,206,82,124
286290,W00003581,W00003581,Output Areas and Small Areas,OASA,209,101,108
286291,W00003582,W00003582,Output Areas and Small Areas,OASA,271,92,179
286292,W00003583,W00003583,Output Areas and Small Areas,OASA,120,55,65
286293,W00003584,W00003584,Output Areas and Small Areas,OASA,247,100,147
286294,W00003585,W00003585,Output Areas and Small Areas,OASA,228,98,130
286295,W00003586,W00003586,Output Areas and Small Areas,OASA,286,123,163
286296,W00003587,W00003587,Output Areas and Small Areas,OASA,312,110,202
286297,W00003588,W00003588,Output Areas and Small Areas,OASA,258,89,169
286298,W00003589,W00003589,Output Areas and Small Areas,OASA,215,43,172
286299,W00003590,W00003590,Output Areas and Small Areas,OASA,300,109,191
286300,W00003591,W00003591,Output Areas and Small Areas,OASA,230,68,162
286301,W00003592,W00003592,Output Areas and Small Areas,OASA,240,83,157
286302,W00003593,W00003593,Output Areas and Small Areas,OASA,189,37,152
286303,W00003594,W00003594,Output Areas and Small Areas,OASA,241,89,152
286304,W00003595,W00003595,Output Areas and Small Areas,OASA,216,64,152
286305,W00003596,W00003596,Output Areas and Small Areas,OASA,240,60,180
286306,W00003597,W00003597,Output Areas and Small Areas,OASA,216,61,155
286307,W00003598,W00003598,Output Areas and Small Areas,OASA,228,87,141
286308,W00003599,W00003599,Output Areas and Small Areas,OASA,275,73,202
286309,W00003600,W00003600,Output Areas and Small Areas,OASA,242,61,181
286310,W00003601,W00003601,Output Areas and Small Areas,OASA,249,96,153
286311,W00003602,W00003602,Output Areas and Small Areas,OASA,340,122,218
286312,W00003603,W00003603,Output Areas and Small Areas,OASA,203,86,117
286313,W00003604,W00003604,Output Areas and Small Areas,OASA,189,89,100
286314,W00003605,W00003605,Output Areas and Small Areas,OASA,239,99,140
286315,W00003606,W00003606,Output Areas and Small Areas,OASA,238,91,147
286316,W00003607,W00003607,Output Areas and Small Areas,OASA,245,114,131
286317,W00003608,W00003608,Output Areas and Small Areas,OASA,352,148,204
286318,W00003609,W00003609,Output Areas and Small Areas,OASA,241,118,123
286319,W00003610,W00003610,Output Areas and Small Areas,OASA,214,85,129
286320,W00003611,W00003611,Output Areas and Small Areas,OASA,332,152,180
286321,W00003612,W00003612,Output Areas and Small Areas,OASA,255,130,125
286322,W00003613,W00003613,Output Areas and Small Areas,OASA,358,85,273
286323,W00003614,W00003614,Output Areas and Small Areas,OASA,170,21,149
286324,W00003615,W00003615,Output Areas and Small Areas,OASA,171,38,133
286325,W00003616,W00003616,Output Areas and Small Areas,OASA,155,23,132
286326,W00003617,W00003617,Output Areas and Small Areas,OASA,162,22,140
286327,W00003618,W00003618,Output Areas and Small Areas,OASA,355,65,290
286328,W00003619,W00003619,Output Areas and Small Areas,OASA,285,84,201
286329,W00003620,W00003620,Output Areas and Small Areas,OASA,202,29,173
286330,W00003621,W00003621,Output Areas and Small Areas,OASA,226,40,186
286331,W00003622,W00003622,Output Areas and Small Areas,OASA,114,11,103
286332,W00003623,W00003623,Output Areas and Small Areas,OASA,181,29,152
286333,W00003624,W00003624,Output Areas and Small Areas,OASA,333,166,167
286334,W00003625,W00003625,Output Areas and Small Areas,OASA,295,158,137
286335,W00003626,W00003626,Output Areas and Small Areas,OASA,340,134,206
286336,W00003627,W00003627,Output Areas and Small Areas,OASA,303,92,211
286337,W00003628,W00003628,Output Areas and Small Areas,OASA,235,119,116
286338,W00003629,W00003629,Output Areas and Small Areas,OASA,245,122,123
286339,W00003630,W00003630,Output Areas and Small Areas,OASA,324,153,171
286340,W00003631,W00003631,Output Areas and Small Areas,OASA,319,177,142
286341,W00003632,W00003632,Output Areas and Small Areas,OASA,305,183,122
286342,W00003633,W00003633,Output Areas and Small Areas,OASA,226,130,96
286343,W00003634,W00003634,Output Areas and Small Areas,OASA,228,162,66
286344,W00003635,W00003635,Output Areas and Small Areas,OASA,263,101,162
286345,W00003636,W00003636,Output Areas and Small Areas,OASA,204,115,89
286346,W00003637,W00003637,Output Areas and Small Areas,OASA,248,143,105
286347,W00003638,W00003638,Output Areas and Small Areas,OASA,286,127,159
286348,W00003639,W00003639,Output Areas and Small Areas,OASA,251,104,147
286349,W00003640,W00003640,Output Areas and Small Areas,OASA,293,158,135
286350,W00003641,W00003641,Output Areas and Small Areas,OASA,195,81,114
286351,W00003642,W00003642,Output Areas and Small Areas,OASA,187,79,108
286352,W00003643,W00003643,Output Areas and Small Areas,OASA,181,90,91
286353,W00003644,W00003644,Output Areas and Small Areas,OASA,221,99,122
286354,W00003645,W00003645,Output Areas and Small Areas,OASA,216,103,113
286355,W00003646,W00003646,Output Areas and Small Areas,OASA,179,73,106
286356,W00003647,W00003647,Output Areas and Small Areas,OASA,292,141,151
286357,W00003648,W00003648,Output Areas and Small Areas,OASA,209,82,127
286358,W00003649,W00003649,Output Areas and Small Areas,OASA,186,59,127
286359,W00003650,W00003650,Output Areas and Small Areas,OASA,271,106,165
286360,W00003651,W00003651,Output Areas and Small Areas,OASA,169,56,113
286361,W00003652,W00003652,Output Areas and Small Areas,OASA,192,77,115
286362,W00003653,W00003653,Output Areas and Small Areas,OASA,203,80,123
286363,W00003654,W00003654,Output Areas and Small Areas,OASA,203,73,130
286364,W00003655,W00003655,Output Areas and Small Areas,OASA,233,82,151
286365,W00003656,W00003656,Output Areas and Small Areas,OASA,305,76,229
286366,W00003657,W00003657,Output Areas and Small Areas,OASA,294,172,122
286367,W00003658,W00003658,Output Areas and Small Areas,OASA,301,152,149
286368,W00003659,W00003659,Output Areas and Small Areas,OASA,195,107,88
286369,W00003660,W00003660,Output Areas and Small Areas,OASA,241,114,127
286370,W00003661,W00003661,Output Areas and Small Areas,OASA,253,158,95
286371,W00003662,W00003662,Output Areas and Small Areas,OASA,226,125,101
286372,W00003663,W00003663,Output Areas and Small Areas,OASA,308,164,144
286373,W00003664,W00003664,Output Areas and Small Areas,OASA,177,90,87
286374,W00003665,W00003665,Output Areas and Small Areas,OASA,333,171,162
286375,W00003666,W00003666,Output Areas and Small Areas,OASA,225,114,111
286376,W00003667,W00003667,Output Areas and Small Areas,OASA,231,149,82
286377,W00003668,W00003668,Output Areas and Small Areas,OASA,220,141,79
286378,W00003669,W00003669,Output Areas and Small Areas,OASA,240,120,120
286379,W00003670,W00003670,Output Areas and Small Areas,OASA,275,149,126
286380,W00003671,W00003671,Output Areas and Small Areas,OASA,426,265,161
286381,W00003672,W00003672,Output Areas and Small Areas,OASA,199,113,86
286382,W00003673,W00003673,Output Areas and Small Areas,OASA,131,47,84
286383,W00003674,W00003674,Output Areas and Small Areas,OASA,181,89,92
286384,W00003675,W00003675,Output Areas and Small Areas,OASA,193,84,109
286385,W00003676,W00003676,Output Areas and Small Areas,OASA,208,58,150
286386,W00003677,W00003677,Output Areas and Small Areas,OASA,211,86,125
286387,W00003678,W00003678,Output Areas and Small Areas,OASA,194,90,104
286388,W00003679,W00003679,Output Areas and Small Areas,OASA,289,180,109
286389,W00003680,W00003680,Output Areas and Small Areas,OASA,232,114,118
286390,W00003681,W00003681,Output Areas and Small Areas,OASA,305,117,188
286391,W00003682,W00003682,Output Areas and Small Areas,OASA,270,108,162
286392,W00003683,W00003683,Output Areas and Small Areas,OASA,248,102,146
286393,W00003684,W00003684,Output Areas and Small Areas,OASA,184,107,77
286394,W00003685,W00003685,Output Areas and Small Areas,OASA,355,194,161
286395,W00003686,W00003686,Output Areas and Small Areas,OASA,286,156,130
286396,W00003687,W00003687,Output Areas and Small Areas,OASA,269,148,121
286397,W00003688,W00003688,Output Areas and Small Areas,OASA,223,118,105
286398,W00003689,W00003689,Output Areas and Small Areas,OASA,207,113,94
286399,W00003690,W00003690,Output Areas and Small Areas,OASA,266,151,115
286400,W00003691,W00003691,Output Areas and Small Areas,OASA,202,87,115
286401,W00003692,W00003692,Output Areas and Small Areas,OASA,303,168,135
286402,W00003693,W00003693,Output Areas and Small Areas,OASA,232,131,101
286403,W00003694,W00003694,Output Areas and Small Areas,OASA,194,95,99
286404,W00003695,W00003695,Output Areas and Small Areas,OASA,293,151,142
286405,W00003696,W00003696,Output Areas and Small Areas,OASA,228,138,90
286406,W00003697,W00003697,Output Areas and Small Areas,OASA,280,160,120
286407,W00003698,W00003698,Output Areas and Small Areas,OASA,266,113,153
286408,W00003699,W00003699,Output Areas and Small Areas,OASA,348,162,186
286409,W00003700,W00003700,Output Areas and Small Areas,OASA,255,128,127
286410,W00003701,W00003701,Output Areas and Small Areas,OASA,286,139,147
286411,W00003702,W00003702,Output Areas and Small Areas,OASA,317,174,143
286412,W00003703,W00003703,Output Areas and Small Areas,OASA,240,134,106
286413,W00003704,W00003704,Output Areas and Small Areas,OASA,222,95,127
286414,W00003705,W00003705,Output Areas and Small Areas,OASA,283,129,154
286415,W00003706,W00003706,Output Areas and Small Areas,OASA,277,128,149
286416,W00003707,W00003707,Output Areas and Small Areas,OASA,207,100,107
286417,W00003708,W00003708,Output Areas and Small Areas,OASA,299,125,174
286418,W00003709,W00003709,Output Areas and Small Areas,OASA,252,154,98
286419,W00003710,W00003710,Output Areas and Small Areas,OASA,182,96,86
286420,W00003711,W00003711,Output Areas and Small Areas,OASA,265,89,176
286421,W00003712,W00003712,Output Areas and Small Areas,OASA,291,100,191
286422,W00003713,W00003713,Output Areas and Small Areas,OASA,225,109,116
286423,W00003714,W00003714,Output Areas and Small Areas,OASA,181,42,139
286424,W00003715,W00003715,Output Areas and Small Areas,OASA,335,137,198
286425,W00003716,W00003716,Output Areas and Small Areas,OASA,331,115,216
286426,W00003717,W00003717,Output Areas and Small Areas,OASA,243,78,165
286427,W00003718,W00003718,Output Areas and Small Areas,OASA,253,106,147
286428,W00003719,W00003719,Output Areas and Small Areas,OASA,268,88,180
286429,W00003720,W00003720,Output Areas and Small Areas,OASA,224,91,133
286430,W00003721,W00003721,Output Areas and Small Areas,OASA,311,134,177
286431,W00003722,W00003722,Output Areas and Small Areas,OASA,323,112,211
286432,W00003723,W00003723,Output Areas and Small Areas,OASA,327,131,196
286433,W00003724,W00003724,Output Areas and Small Areas,OASA,227,72,155
286434,W00003725,W00003725,Output Areas and Small Areas,OASA,224,106,118
286435,W00003726,W00003726,Output Areas and Small Areas,OASA,294,134,160
286436,W00003727,W00003727,Output Areas and Small Areas,OASA,190,101,89
286437,W00003728,W00003728,Output Areas and Small Areas,OASA,241,109,132
286438,W00003729,W00003729,Output Areas and Small Areas,OASA,455,178,277
286439,W00003730,W00003730,Output Areas and Small Areas,OASA,213,105,108
286440,W00003731,W00003731,Output Areas and Small Areas,OASA,219,105,114
286441,W00003732,W00003732,Output Areas and Small Areas,OASA,243,121,122
286442,W00003733,W00003733,Output Areas and Small Areas,OASA,161,65,96
286443,W00003734,W00003734,Output Areas and Small Areas,OASA,247,158,89
286444,W00003735,W00003735,Output Areas and Small Areas,OASA,251,151,100
286445,W00003736,W00003736,Output Areas and Small Areas,OASA,238,144,94
286446,W00003737,W00003737,Output Areas and Small Areas,OASA,273,171,102
286447,W00003738,W00003738,Output Areas and Small Areas,OASA,276,125,151
286448,W00003739,W00003739,Output Areas and Small Areas,OASA,227,149,78
286449,W00003740,W00003740,Output Areas and Small Areas,OASA,308,162,146
286450,W00003741,W00003741,Output Areas and Small Areas,OASA,226,94,132
286451,W00003742,W00003742,Output Areas and Small Areas,OASA,252,149,103
286452,W00003743,W00003743,Output Areas and Small Areas,OASA,283,142,141
286453,W00003744,W00003744,Output Areas and Small Areas,OASA,232,156,76
286454,W00003745,W00003745,Output Areas and Small Areas,OASA,312,139,173
286455,W00003746,W00003746,Output Areas and Small Areas,OASA,285,123,162
286456,W00003747,W00003747,Output Areas and Small Areas,OASA,393,185,208
286457,W00003748,W00003748,Output Areas and Small Areas,OASA,241,162,79
286458,W00003749,W00003749,Output Areas and Small Areas,OASA,307,197,110
286459,W00003750,W00003750,Output Areas and Small Areas,OASA,275,186,89
286460,W00003751,W00003751,Output Areas and Small Areas,OASA,259,168,91
286461,W00003752,W00003752,Output Areas and Small Areas,OASA,311,202,109
286462,W00003753,W00003753,Output Areas and Small Areas,OASA,215,130,85
286463,W00003754,W00003754,Output Areas and Small Areas,OASA,213,137,76
286464,W00003755,W00003755,Output Areas and Small Areas,OASA,276,190,86
286465,W00003756,W00003756,Output Areas and Small Areas,OASA,214,140,74
286466,W00003757,W00003757,Output Areas and Small Areas,OASA,236,157,79
286467,W00003758,W00003758,Output Areas and Small Areas,OASA,318,215,103
286468,W00003759,W00003759,Output Areas and Small Areas,OASA,228,171,57
286469,W00003760,W00003760,Output Areas and Small Areas,OASA,255,103,152
286470,W00003761,W00003761,Output Areas and Small Areas,OASA,240,99,141
286471,W00003762,W00003762,Output Areas and Small Areas,OASA,252,92,160
286472,W00003763,W00003763,Output Areas and Small Areas,OASA,169,63,106
286473,W00003764,W00003764,Output Areas and Small Areas,OASA,238,111,127
286474,W00003765,W00003765,Output Areas and Small Areas,OASA,189,82,107
286475,W00003766,W00003766,Output Areas and Small Areas,OASA,182,77,105
286476,W00003767,W00003767,Output Areas and Small Areas,OASA,198,71,127
286477,W00003768,W00003768,Output Areas and Small Areas,OASA,383,269,114
286478,W00003769,W00003769,Output Areas and Small Areas,OASA,193,96,97
286479,W00003770,W00003770,Output Areas and Small Areas,OASA,348,142,206
286480,W00003771,W00003771,Output Areas and Small Areas,OASA,230,88,142
286481,W00003772,W00003772,Output Areas and Small Areas,OASA,180,118,62
286482,W00003773,W00003773,Output Areas and Small Areas,OASA,276,155,121
286483,W00003774,W00003774,Output Areas and Small Areas,OASA,229,138,91
286484,W00003775,W00003775,Output Areas and Small Areas,OASA,225,106,119
286485,W00003776,W00003776,Output Areas and Small Areas,OASA,197,128,69
286486,W00003777,W00003777,Output Areas and Small Areas,OASA,244,88,156
286487,W00003778,W00003778,Output Areas and Small Areas,OASA,275,68,207
286488,W00003779,W00003779,Output Areas and Small Areas,OASA,229,43,186
286489,W00003780,W00003780,Output Areas and Small Areas,OASA,236,42,194
286490,W00003781,W00003781,Output Areas and Small Areas,OASA,262,59,203
286491,W00003782,W00003782,Output Areas and Small Areas,OASA,252,73,179
286492,W00003783,W00003783,Output Areas and Small Areas,OASA,224,90,134
286493,W00003784,W00003784,Output Areas and Small Areas,OASA,227,76,151
286494,W00003785,W00003785,Output Areas and Small Areas,OASA,220,48,172
286495,W00003786,W00003786,Output Areas and Small Areas,OASA,240,56,184
286496,W00003787,W00003787,Output Areas and Small Areas,OASA,227,76,151
286497,W00003788,W00003788,Output Areas and Small Areas,OASA,212,73,139
286498,W00003789,W00003789,Output Areas and Small Areas,OASA,263,48,215
286499,W00003790,W00003790,Output Areas and Small Areas,OASA,229,62,167
286500,W00003791,W00003791,Output Areas and Small Areas,OASA,203,46,157
286501,W00003792,W00003792,Output Areas and Small Areas,OASA,218,42,176
286502,W00003793,W00003793,Output Areas and Small Areas,OASA,365,88,277
286503,W00003794,W00003794,Output Areas and Small Areas,OASA,228,83,145
286504,W00003795,W00003795,Output Areas and Small Areas,OASA,199,51,148
286505,W00003796,W00003796,Output Areas and Small Areas,OASA,319,62,257
286506,W00003797,W00003797,Output Areas and Small Areas,OASA,250,59,191
286507,W00003798,W00003798,Output Areas and Small Areas,OASA,237,54,183
286508,W00003799,W00003799,Output Areas and Small Areas,OASA,215,64,151
286509,W00003800,W00003800,Output Areas and Small Areas,OASA,301,79,222
286510,W00003801,W00003801,Output Areas and Small Areas,OASA,248,58,190
286511,W00003802,W00003802,Output Areas and Small Areas,OASA,239,56,183
286512,W00003803,W00003803,Output Areas and Small Areas,OASA,212,56,156
286513,W00003804,W00003804,Output Areas and Small Areas,OASA,209,60,149
286514,W00003805,W00003805,Output Areas and Small Areas,OASA,209,71,138
286515,W00003806,W00003806,Output Areas and Small Areas,OASA,209,37,172
286516,W00003807,W00003807,Output Areas and Small Areas,OASA,225,48,177
286517,W00003808,W00003808,Output Areas and Small Areas,OASA,187,29,158
286518,W00003809,W00003809,Output Areas and Small Areas,OASA,215,34,181
286519,W00003811,W00003811,Output Areas and Small Areas,OASA,280,129,151
286520,W00003812,W00003812,Output Areas and Small Areas,OASA,267,123,144
286521,W00003813,W00003813,Output Areas and Small Areas,OASA,238,162,76
286522,W00003814,W00003814,Output Areas and Small Areas,OASA,320,138,182
286523,W00003815,W00003815,Output Areas and Small Areas,OASA,407,147,260
286524,W00003817,W00003817,Output Areas and Small Areas,OASA,318,133,185
286525,W00003818,W00003818,Output Areas and Small Areas,OASA,255,46,209
286526,W00003819,W00003819,Output Areas and Small Areas,OASA,252,64,188
286527,W00003820,W00003820,Output Areas and Small Areas,OASA,258,84,174
286528,W00003821,W00003821,Output Areas and Small Areas,OASA,295,104,191
286529,W00003823,W00003823,Output Areas and Small Areas,OASA,212,55,157
286530,W00003824,W00003824,Output Areas and Small Areas,OASA,205,50,155
286531,W00003825,W00003825,Output Areas and Small Areas,OASA,256,59,197
286532,W00003826,W00003826,Output Areas and Small Areas,OASA,228,48,180
286533,W00003827,W00003827,Output Areas and Small Areas,OASA,232,67,165
286534,W00003828,W00003828,Output Areas and Small Areas,OASA,228,49,179
286535,W00003829,W00003829,Output Areas and Small Areas,OASA,189,63,126
286536,W00003830,W00003830,Output Areas and Small Areas,OASA,353,219,134
286537,W00003831,W00003831,Output Areas and Small Areas,OASA,254,156,98
286538,W00003832,W00003832,Output Areas and Small Areas,OASA,246,149,97
286539,W00003833,W00003833,Output Areas and Small Areas,OASA,245,147,98
286540,W00003834,W00003834,Output Areas and Small Areas,OASA,274,173,101
286541,W00003835,W00003835,Output Areas and Small Areas,OASA,267,156,111
286542,W00003836,W00003836,Output Areas and Small Areas,OASA,380,180,200
286543,W00003837,W00003837,Output Areas and Small Areas,OASA,319,180,139
286544,W00003838,W00003838,Output Areas and Small Areas,OASA,286,176,110
286545,W00003839,W00003839,Output Areas and Small Areas,OASA,302,148,154
286546,W00003840,W00003840,Output Areas and Small Areas,OASA,243,131,112
286547,W00003841,W00003841,Output Areas and Small Areas,OASA,215,100,115
286548,W00003842,W00003842,Output Areas and Small Areas,OASA,250,121,129
286549,W00003843,W00003843,Output Areas and Small Areas,OASA,223,115,108
286550,W00003844,W00003844,Output Areas and Small Areas,OASA,296,152,144
286551,W00003845,W00003845,Output Areas and Small Areas,OASA,208,103,105
286552,W00003846,W00003846,Output Areas and Small Areas,OASA,246,135,111
286553,W00003847,W00003847,Output Areas and Small Areas,OASA,288,196,92
286554,W00003848,W00003848,Output Areas and Small Areas,OASA,410,257,153
286555,W00003849,W00003849,Output Areas and Small Areas,OASA,259,173,86
286556,W00003850,W00003850,Output Areas and Small Areas,OASA,240,160,80
286557,W00003851,W00003851,Output Areas and Small Areas,OASA,243,137,106
286558,W00003852,W00003852,Output Areas and Small Areas,OASA,208,134,74
286559,W00003853,W00003853,Output Areas and Small Areas,OASA,191,126,65
286560,W00003854,W00003854,Output Areas and Small Areas,OASA,224,145,79
286561,W00003855,W00003855,Output Areas and Small Areas,OASA,229,157,72
286562,W00003856,W00003856,Output Areas and Small Areas,OASA,214,107,107
286563,W00003857,W00003857,Output Areas and Small Areas,OASA,253,191,62
286564,W00003858,W00003858,Output Areas and Small Areas,OASA,282,185,97
286565,W00003859,W00003859,Output Areas and Small Areas,OASA,299,176,123
286566,W00003860,W00003860,Output Areas and Small Areas,OASA,242,160,82
286567,W00003861,W00003861,Output Areas and Small Areas,OASA,210,152,58
286568,W00003862,W00003862,Output Areas and Small Areas,OASA,236,151,85
286569,W00003863,W00003863,Output Areas and Small Areas,OASA,209,136,73
286570,W00003864,W00003864,Output Areas and Small Areas,OASA,229,154,75
286571,W00003865,W00003865,Output Areas and Small Areas,OASA,201,145,56
286572,W00003866,W00003866,Output Areas and Small Areas,OASA,242,131,111
286573,W00003867,W00003867,Output Areas and Small Areas,OASA,273,163,110
286574,W00003868,W00003868,Output Areas and Small Areas,OASA,273,132,141
286575,W00003869,W00003869,Output Areas and Small Areas,OASA,336,163,173
286576,W00003870,W00003870,Output Areas and Small Areas,OASA,244,94,150
286577,W00003871,W00003871,Output Areas and Small Areas,OASA,316,121,195
286578,W00003872,W00003872,Output Areas and Small Areas,OASA,343,173,170
286579,W00003873,W00003873,Output Areas and Small Areas,OASA,267,108,159
286580,W00003874,W00003874,Output Areas and Small Areas,OASA,216,104,112
286581,W00003875,W00003875,Output Areas and Small Areas,OASA,256,139,117
286582,W00003876,W00003876,Output Areas and Small Areas,OASA,310,143,167
286583,W00003877,W00003877,Output Areas and Small Areas,OASA,317,187,130
286584,W00003878,W00003878,Output Areas and Small Areas,OASA,260,159,101
286585,W00003879,W00003879,Output Areas and Small Areas,OASA,250,116,134
286586,W00003880,W00003880,Output Areas and Small Areas,OASA,189,89,100
286587,W00003881,W00003881,Output Areas and Small Areas,OASA,261,78,183
286588,W00003882,W00003882,Output Areas and Small Areas,OASA,185,56,129
286589,W00003883,W00003883,Output Areas and Small Areas,OASA,274,83,191
286590,W00003884,W00003884,Output Areas and Small Areas,OASA,423,195,228
286591,W00003885,W00003885,Output Areas and Small Areas,OASA,327,158,169
286592,W00003886,W00003886,Output Areas and Small Areas,OASA,374,204,170
286593,W00003887,W00003887,Output Areas and Small Areas,OASA,284,161,123
286594,W00003888,W00003888,Output Areas and Small Areas,OASA,309,173,136
286595,W00003889,W00003889,Output Areas and Small Areas,OASA,301,166,135
286596,W00003890,W00003890,Output Areas and Small Areas,OASA,295,149,146
286597,W00003891,W00003891,Output Areas and Small Areas,OASA,321,129,192
286598,W00003892,W00003892,Output Areas and Small Areas,OASA,260,135,125
286599,W00003893,W00003893,Output Areas and Small Areas,OASA,165,90,75
286600,W00003894,W00003894,Output Areas and Small Areas,OASA,337,175,162
286601,W00003895,W00003895,Output Areas and Small Areas,OASA,312,121,191
286602,W00003896,W00003896,Output Areas and Small Areas,OASA,239,98,141
286603,W00003897,W00003897,Output Areas and Small Areas,OASA,140,62,78
286604,W00003898,W00003898,Output Areas and Small Areas,OASA,315,91,224
286605,W00003899,W00003899,Output Areas and Small Areas,OASA,295,74,221
286606,W00003900,W00003900,Output Areas and Small Areas,OASA,210,65,145
286607,W00003901,W00003901,Output Areas and Small Areas,OASA,192,43,149
286608,W00003902,W00003902,Output Areas and Small Areas,OASA,233,71,162
286609,W00003903,W00003903,Output Areas and Small Areas,OASA,242,67,175
286610,W00003904,W00003904,Output Areas and Small Areas,OASA,246,118,128
286611,W00003905,W00003905,Output Areas and Small Areas,OASA,392,170,222
286612,W00003906,W00003906,Output Areas and Small Areas,OASA,248,119,129
286613,W00003907,W00003907,Output Areas and Small Areas,OASA,239,112,127
286614,W00003908,W00003908,Output Areas and Small Areas,OASA,319,179,140
286615,W00003909,W00003909,Output Areas and Small Areas,OASA,316,171,145
286616,W00003910,W00003910,Output Areas and Small Areas,OASA,279,120,159
286617,W00003911,W00003911,Output Areas and Small Areas,OASA,256,108,148
286618,W00003912,W00003912,Output Areas and Small Areas,OASA,257,142,115
286619,W00003913,W00003913,Output Areas and Small Areas,OASA,266,139,127
286620,W00003914,W00003914,Output Areas and Small Areas,OASA,258,145,113
286621,W00003915,W00003915,Output Areas and Small Areas,OASA,259,81,178
286622,W00003916,W00003916,Output Areas and Small Areas,OASA,245,134,111
286623,W00003917,W00003917,Output Areas and Small Areas,OASA,271,139,132
286624,W00003918,W00003918,Output Areas and Small Areas,OASA,340,167,173
286625,W00003919,W00003919,Output Areas and Small Areas,OASA,288,141,147
286626,W00003920,W00003920,Output Areas and Small Areas,OASA,310,137,173
286627,W00003921,W00003921,Output Areas and Small Areas,OASA,242,97,145
286628,W00003922,W00003922,Output Areas and Small Areas,OASA,279,136,143
286629,W00003923,W00003923,Output Areas and Small Areas,OASA,271,138,133
286630,W00003924,W00003924,Output Areas and Small Areas,OASA,277,120,157
286631,W00003925,W00003925,Output Areas and Small Areas,OASA,268,52,216
286632,W00003926,W00003926,Output Areas and Small Areas,OASA,205,43,162
286633,W00003927,W00003927,Output Areas and Small Areas,OASA,254,50,204
286634,W00003928,W00003928,Output Areas and Small Areas,OASA,209,46,163
286635,W00003929,W00003929,Output Areas and Small Areas,OASA,177,40,137
286636,W00003930,W00003930,Output Areas and Small Areas,OASA,217,32,185
286637,W00003931,W00003931,Output Areas and Small Areas,OASA,254,38,216
286638,W00003932,W00003932,Output Areas and Small Areas,OASA,226,53,173
286639,W00003933,W00003933,Output Areas and Small Areas,OASA,268,55,213
286640,W00003934,W00003934,Output Areas and Small Areas,OASA,209,38,171
286641,W00003935,W00003935,Output Areas and Small Areas,OASA,243,44,199
286642,W00003936,W00003936,Output Areas and Small Areas,OASA,160,24,136
286643,W00003937,W00003937,Output Areas and Small Areas,OASA,181,41,140
286644,W00003938,W00003938,Output Areas and Small Areas,OASA,249,53,196
286645,W00003939,W00003939,Output Areas and Small Areas,OASA,201,54,147
286646,W00003940,W00003940,Output Areas and Small Areas,OASA,399,134,265
286647,W00003941,W00003941,Output Areas and Small Areas,OASA,114,42,72
286648,W00003942,W00003942,Output Areas and Small Areas,OASA,424,189,235
286649,W00003943,W00003943,Output Areas and Small Areas,OASA,249,83,166
286650,W00003944,W00003944,Output Areas and Small Areas,OASA,203,74,129
286651,W00003945,W00003945,Output Areas and Small Areas,OASA,235,76,159
286652,W00003946,W00003946,Output Areas and Small Areas,OASA,239,140,99
286653,W00003947,W00003947,Output Areas and Small Areas,OASA,198,15,183
286654,W00003948,W00003948,Output Areas and Small Areas,OASA,238,17,221
286655,W00003949,W00003949,Output Areas and Small Areas,OASA,173,9,164
286656,W00003950,W00003950,Output Areas and Small Areas,OASA,206,6,200
286657,W00003951,W00003951,Output Areas and Small Areas,OASA,210,15,195
286658,W00003952,W00003952,Output Areas and Small Areas,OASA,214,11,203
286659,W00003953,W00003953,Output Areas and Small Areas,OASA,242,16,226
286660,W00003954,W00003954,Output Areas and Small Areas,OASA,247,24,223
286661,W00003955,W00003955,Output Areas and Small Areas,OASA,254,18,236
286662,W00003956,W00003956,Output Areas and Small Areas,OASA,250,19,231
286663,W00003957,W00003957,Output Areas and Small Areas,OASA,161,12,149
286664,W00003958,W00003958,Output Areas and Small Areas,OASA,371,34,337
286665,W00003960,W00003960,Output Areas and Small Areas,OASA,270,6,264
286666,W00003961,W00003961,Output Areas and Small Areas,OASA,295,28,267
286667,W00003962,W00003962,Output Areas and Small Areas,OASA,247,14,233
286668,W00003963,W00003963,Output Areas and Small Areas,OASA,375,40,335
286669,W00003964,W00003964,Output Areas and Small Areas,OASA,232,12,220
286670,W00003965,W00003965,Output Areas and Small Areas,OASA,214,16,198
286671,W00003966,W00003966,Output Areas and Small Areas,OASA,269,11,258
286672,W00003967,W00003967,Output Areas and Small Areas,OASA,189,12,177
286673,W00003968,W00003968,Output Areas and Small Areas,OASA,236,14,222
286674,W00003969,W00003969,Output Areas and Small Areas,OASA,234,8,226
286675,W00003970,W00003970,Output Areas and Small Areas,OASA,272,19,253
286676,W00003971,W00003971,Output Areas and Small Areas,OASA,219,16,203
286677,W00003972,W00003972,Output Areas and Small Areas,OASA,270,7,263
286678,W00003973,W00003973,Output Areas and Small Areas,OASA,240,18,222
286679,W00003974,W00003974,Output Areas and Small Areas,OASA,243,15,228
286680,W00003975,W00003975,Output Areas and Small Areas,OASA,270,9,261
286681,W00003976,W00003976,Output Areas and Small Areas,OASA,188,6,182
286682,W00003977,W00003977,Output Areas and Small Areas,OASA,241,11,230
286683,W00003978,W00003978,Output Areas and Small Areas,OASA,203,7,196
286684,W00003979,W00003979,Output Areas and Small Areas,OASA,106,6,100
286685,W00003980,W00003980,Output Areas and Small Areas,OASA,142,14,128
286686,W00003981,W00003981,Output Areas and Small Areas,OASA,169,8,161
286687,W00003982,W00003982,Output Areas and Small Areas,OASA,388,21,367
286688,W00003983,W00003983,Output Areas and Small Areas,OASA,324,15,309
286689,W00003984,W00003984,Output Areas and Small Areas,OASA,314,13,301
286690,W00003986,W00003986,Output Areas and Small Areas,OASA,241,8,233
286691,W00003987,W00003987,Output Areas and Small Areas,OASA,208,13,195
286692,W00003988,W00003988,Output Areas and Small Areas,OASA,369,26,343
286693,W00003989,W00003989,Output Areas and Small Areas,OASA,359,21,338
286694,W00003990,W00003990,Output Areas and Small Areas,OASA,276,18,258
286695,W00003991,W00003991,Output Areas and Small Areas,OASA,244,14,230
286696,W00003992,W00003992,Output Areas and Small Areas,OASA,181,13,168
286697,W00003993,W00003993,Output Areas and Small Areas,OASA,331,23,308
286698,W00003995,W00003995,Output Areas and Small Areas,OASA,166,17,149
286699,W00003996,W00003996,Output Areas and Small Areas,OASA,264,11,253
286700,W00003997,W00003997,Output Areas and Small Areas,OASA,505,37,468
286701,W00003998,W00003998,Output Areas and Small Areas,OASA,258,15,243
286702,W00003999,W00003999,Output Areas and Small Areas,OASA,253,19,234
286703,W00004001,W00004001,Output Areas and Small Areas,OASA,182,7,175
286704,W00004002,W00004002,Output Areas and Small Areas,OASA,228,4,224
286705,W00004003,W00004003,Output Areas and Small Areas,OASA,170,2,168
286706,W00004004,W00004004,Output Areas and Small Areas,OASA,338,11,327
286707,W00004005,W00004005,Output Areas and Small Areas,OASA,174,4,170
286708,W00004006,W00004006,Output Areas and Small Areas,OASA,199,3,196
286709,W00004007,W00004007,Output Areas and Small Areas,OASA,238,10,228
286710,W00004008,W00004008,Output Areas and Small Areas,OASA,169,5,164
286711,W00004009,W00004009,Output Areas and Small Areas,OASA,173,9,164
286712,W00004010,W00004010,Output Areas and Small Areas,OASA,245,9,236
286713,W00004011,W00004011,Output Areas and Small Areas,OASA,139,2,137
286714,W00004012,W00004012,Output Areas and Small Areas,OASA,170,12,158
286715,W00004013,W00004013,Output Areas and Small Areas,OASA,224,21,203
286716,W00004014,W00004014,Output Areas and Small Areas,OASA,188,5,183
286717,W00004015,W00004015,Output Areas and Small Areas,OASA,193,14,179
286718,W00004016,W00004016,Output Areas and Small Areas,OASA,311,18,293
286719,W00004017,W00004017,Output Areas and Small Areas,OASA,243,19,224
286720,W00004018,W00004018,Output Areas and Small Areas,OASA,442,27,415
286721,W00004019,W00004019,Output Areas and Small Areas,OASA,305,28,277
286722,W00004020,W00004020,Output Areas and Small Areas,OASA,293,17,276
286723,W00004021,W00004021,Output Areas and Small Areas,OASA,297,35,262
286724,W00004022,W00004022,Output Areas and Small Areas,OASA,288,17,271
286725,W00004023,W00004023,Output Areas and Small Areas,OASA,226,17,209
286726,W00004025,W00004025,Output Areas and Small Areas,OASA,283,46,237
286727,W00004026,W00004026,Output Areas and Small Areas,OASA,205,17,188
286728,W00004027,W00004027,Output Areas and Small Areas,OASA,341,21,320
286729,W00004028,W00004028,Output Areas and Small Areas,OASA,354,21,333
286730,W00004029,W00004029,Output Areas and Small Areas,OASA,275,8,267
286731,W00004030,W00004030,Output Areas and Small Areas,OASA,266,39,227
286732,W00004031,W00004031,Output Areas and Small Areas,OASA,290,84,206
286733,W00004032,W00004032,Output Areas and Small Areas,OASA,250,57,193
286734,W00004033,W00004033,Output Areas and Small Areas,OASA,394,58,336
286735,W00004034,W00004034,Output Areas and Small Areas,OASA,268,73,195
286736,W00004035,W00004035,Output Areas and Small Areas,OASA,258,54,204
286737,W00004036,W00004036,Output Areas and Small Areas,OASA,263,33,230
286738,W00004037,W00004037,Output Areas and Small Areas,OASA,234,46,188
286739,W00004038,W00004038,Output Areas and Small Areas,OASA,221,19,202
286740,W00004039,W00004039,Output Areas and Small Areas,OASA,183,30,153
286741,W00004040,W00004040,Output Areas and Small Areas,OASA,229,21,208
286742,W00004041,W00004041,Output Areas and Small Areas,OASA,227,44,183
286743,W00004042,W00004042,Output Areas and Small Areas,OASA,213,28,185
286744,W00004043,W00004043,Output Areas and Small Areas,OASA,250,53,197
286745,W00004044,W00004044,Output Areas and Small Areas,OASA,287,61,226
286746,W00004045,W00004045,Output Areas and Small Areas,OASA,243,18,225
286747,W00004046,W00004046,Output Areas and Small Areas,OASA,212,35,177
286748,W00004047,W00004047,Output Areas and Small Areas,OASA,213,23,190
286749,W00004048,W00004048,Output Areas and Small Areas,OASA,181,25,156
286750,W00004049,W00004049,Output Areas and Small Areas,OASA,253,33,220
286751,W00004050,W00004050,Output Areas and Small Areas,OASA,224,38,186
286752,W00004051,W00004051,Output Areas and Small Areas,OASA,207,30,177
286753,W00004052,W00004052,Output Areas and Small Areas,OASA,229,65,164
286754,W00004053,W00004053,Output Areas and Small Areas,OASA,211,38,173
286755,W00004054,W00004054,Output Areas and Small Areas,OASA,260,62,198
286756,W00004055,W00004055,Output Areas and Small Areas,OASA,257,18,239
286757,W00004056,W00004056,Output Areas and Small Areas,OASA,239,30,209
286758,W00004057,W00004057,Output Areas and Small Areas,OASA,240,14,226
286759,W00004058,W00004058,Output Areas and Small Areas,OASA,254,10,244
286760,W00004059,W00004059,Output Areas and Small Areas,OASA,252,16,236
286761,W00004060,W00004060,Output Areas and Small Areas,OASA,268,24,244
286762,W00004061,W00004061,Output Areas and Small Areas,OASA,217,11,206
286763,W00004062,W00004062,Output Areas and Small Areas,OASA,287,7,280
286764,W00004063,W00004063,Output Areas and Small Areas,OASA,219,16,203
286765,W00004064,W00004064,Output Areas and Small Areas,OASA,245,25,220
286766,W00004065,W00004065,Output Areas and Small Areas,OASA,264,18,246
286767,W00004066,W00004066,Output Areas and Small Areas,OASA,175,9,166
286768,W00004067,W00004067,Output Areas and Small Areas,OASA,257,7,250
286769,W00004068,W00004068,Output Areas and Small Areas,OASA,133,10,123
286770,W00004069,W00004069,Output Areas and Small Areas,OASA,157,10,147
286771,W00004070,W00004070,Output Areas and Small Areas,OASA,228,23,205
286772,W00004071,W00004071,Output Areas and Small Areas,OASA,449,32,417
286773,W00004072,W00004072,Output Areas and Small Areas,OASA,241,24,217
286774,W00004073,W00004073,Output Areas and Small Areas,OASA,399,23,376
286775,W00004074,W00004074,Output Areas and Small Areas,OASA,204,12,192
286776,W00004075,W00004075,Output Areas and Small Areas,OASA,447,30,417
286777,W00004076,W00004076,Output Areas and Small Areas,OASA,240,20,220
286778,W00004077,W00004077,Output Areas and Small Areas,OASA,226,15,211
286779,W00004078,W00004078,Output Areas and Small Areas,OASA,366,30,336
286780,W00004079,W00004079,Output Areas and Small Areas,OASA,289,33,256
286781,W00004080,W00004080,Output Areas and Small Areas,OASA,217,18,199
286782,W00004081,W00004081,Output Areas and Small Areas,OASA,238,18,220
286783,W00004082,W00004082,Output Areas and Small Areas,OASA,232,13,219
286784,W00004083,W00004083,Output Areas and Small Areas,OASA,221,12,209
286785,W00004084,W00004084,Output Areas and Small Areas,OASA,228,21,207
286786,W00004085,W00004085,Output Areas and Small Areas,OASA,318,31,287
286787,W00004086,W00004086,Output Areas and Small Areas,OASA,257,24,233
286788,W00004087,W00004087,Output Areas and Small Areas,OASA,233,19,214
286789,W00004088,W00004088,Output Areas and Small Areas,OASA,269,16,253
286790,W00004089,W00004089,Output Areas and Small Areas,OASA,243,17,226
286791,W00004090,W00004090,Output Areas and Small Areas,OASA,219,4,215
286792,W00004091,W00004091,Output Areas and Small Areas,OASA,240,15,225
286793,W00004092,W00004092,Output Areas and Small Areas,OASA,210,10,200
286794,W00004093,W00004093,Output Areas and Small Areas,OASA,253,5,248
286795,W00004094,W00004094,Output Areas and Small Areas,OASA,194,10,184
286796,W00004095,W00004095,Output Areas and Small Areas,OASA,214,11,203
286797,W00004096,W00004096,Output Areas and Small Areas,OASA,272,20,252
286798,W00004097,W00004097,Output Areas and Small Areas,OASA,271,47,224
286799,W00004098,W00004098,Output Areas and Small Areas,OASA,255,13,242
286800,W00004099,W00004099,Output Areas and Small Areas,OASA,252,5,247
286801,W00004100,W00004100,Output Areas and Small Areas,OASA,266,10,256
286802,W00004101,W00004101,Output Areas and Small Areas,OASA,239,10,229
286803,W00004102,W00004102,Output Areas and Small Areas,OASA,188,8,180
286804,W00004103,W00004103,Output Areas and Small Areas,OASA,237,10,227
286805,W00004104,W00004104,Output Areas and Small Areas,OASA,273,10,263
286806,W00004105,W00004105,Output Areas and Small Areas,OASA,302,13,289
286807,W00004106,W00004106,Output Areas and Small Areas,OASA,172,7,165
286808,W00004107,W00004107,Output Areas and Small Areas,OASA,233,2,231
286809,W00004108,W00004108,Output Areas and Small Areas,OASA,253,16,237
286810,W00004109,W00004109,Output Areas and Small Areas,OASA,274,8,266
286811,W00004110,W00004110,Output Areas and Small Areas,OASA,266,13,253
286812,W00004111,W00004111,Output Areas and Small Areas,OASA,225,6,219
286813,W00004112,W00004112,Output Areas and Small Areas,OASA,269,14,255
286814,W00004113,W00004113,Output Areas and Small Areas,OASA,221,19,202
286815,W00004114,W00004114,Output Areas and Small Areas,OASA,218,7,211
286816,W00004115,W00004115,Output Areas and Small Areas,OASA,212,14,198
286817,W00004116,W00004116,Output Areas and Small Areas,OASA,211,9,202
286818,W00004117,W00004117,Output Areas and Small Areas,OASA,275,18,257
286819,W00004118,W00004118,Output Areas and Small Areas,OASA,232,8,224
286820,W00004119,W00004119,Output Areas and Small Areas,OASA,209,10,199
286821,W00004120,W00004120,Output Areas and Small Areas,OASA,269,14,255
286822,W00004121,W00004121,Output Areas and Small Areas,OASA,211,16,195
286823,W00004122,W00004122,Output Areas and Small Areas,OASA,250,19,231
286824,W00004123,W00004123,Output Areas and Small Areas,OASA,223,7,216
286825,W00004124,W00004124,Output Areas and Small Areas,OASA,195,8,187
286826,W00004125,W00004125,Output Areas and Small Areas,OASA,211,14,197
286827,W00004126,W00004126,Output Areas and Small Areas,OASA,229,14,215
286828,W00004127,W00004127,Output Areas and Small Areas,OASA,225,16,209
286829,W00004128,W00004128,Output Areas and Small Areas,OASA,215,10,205
286830,W00004129,W00004129,Output Areas and Small Areas,OASA,261,15,246
286831,W00004130,W00004130,Output Areas and Small Areas,OASA,230,11,219
286832,W00004131,W00004131,Output Areas and Small Areas,OASA,252,18,234
286833,W00004132,W00004132,Output Areas and Small Areas,OASA,226,11,215
286834,W00004133,W00004133,Output Areas and Small Areas,OASA,230,12,218
286835,W00004134,W00004134,Output Areas and Small Areas,OASA,252,18,234
286836,W00004135,W00004135,Output Areas and Small Areas,OASA,264,9,255
286837,W00004136,W00004136,Output Areas and Small Areas,OASA,273,12,261
286838,W00004137,W00004137,Output Areas and Small Areas,OASA,229,12,217
286839,W00004138,W00004138,Output Areas and Small Areas,OASA,235,10,225
286840,W00004139,W00004139,Output Areas and Small Areas,OASA,270,11,259
286841,W00004140,W00004140,Output Areas and Small Areas,OASA,320,33,287
286842,W00004141,W00004141,Output Areas and Small Areas,OASA,218,18,200
286843,W00004142,W00004142,Output Areas and Small Areas,OASA,269,35,234
286844,W00004143,W00004143,Output Areas and Small Areas,OASA,330,21,309
286845,W00004144,W00004144,Output Areas and Small Areas,OASA,135,14,121
286846,W00004145,W00004145,Output Areas and Small Areas,OASA,312,20,292
286847,W00004146,W00004146,Output Areas and Small Areas,OASA,254,12,242
286848,W00004147,W00004147,Output Areas and Small Areas,OASA,307,22,285
286849,W00004148,W00004148,Output Areas and Small Areas,OASA,224,11,213
286850,W00004149,W00004149,Output Areas and Small Areas,OASA,247,27,220
286851,W00004150,W00004150,Output Areas and Small Areas,OASA,202,33,169
286852,W00004151,W00004151,Output Areas and Small Areas,OASA,227,16,211
286853,W00004152,W00004152,Output Areas and Small Areas,OASA,254,47,207
286854,W00004153,W00004153,Output Areas and Small Areas,OASA,291,25,266
286855,W00004154,W00004154,Output Areas and Small Areas,OASA,321,45,276
286856,W00004155,W00004155,Output Areas and Small Areas,OASA,181,27,154
286857,W00004157,W00004157,Output Areas and Small Areas,OASA,319,28,291
286858,W00004158,W00004158,Output Areas and Small Areas,OASA,248,17,231
286859,W00004159,W00004159,Output Areas and Small Areas,OASA,319,26,293
286860,W00004160,W00004160,Output Areas and Small Areas,OASA,144,12,132
286861,W00004161,W00004161,Output Areas and Small Areas,OASA,318,24,294
286862,W00004162,W00004162,Output Areas and Small Areas,OASA,304,33,271
286863,W00004163,W00004163,Output Areas and Small Areas,OASA,425,38,387
286864,W00004164,W00004164,Output Areas and Small Areas,OASA,166,13,153
286865,W00004165,W00004165,Output Areas and Small Areas,OASA,267,23,244
286866,W00004166,W00004166,Output Areas and Small Areas,OASA,364,15,349
286867,W00004167,W00004167,Output Areas and Small Areas,OASA,189,11,178
286868,W00004168,W00004168,Output Areas and Small Areas,OASA,304,20,284
286869,W00004169,W00004169,Output Areas and Small Areas,OASA,340,20,320
286870,W00004170,W00004170,Output Areas and Small Areas,OASA,236,12,224
286871,W00004171,W00004171,Output Areas and Small Areas,OASA,242,10,232
286872,W00004172,W00004172,Output Areas and Small Areas,OASA,319,35,284
286873,W00004173,W00004173,Output Areas and Small Areas,OASA,153,16,137
286874,W00004174,W00004174,Output Areas and Small Areas,OASA,293,37,256
286875,W00004175,W00004175,Output Areas and Small Areas,OASA,242,37,205
286876,W00004176,W00004176,Output Areas and Small Areas,OASA,326,32,294
286877,W00004177,W00004177,Output Areas and Small Areas,OASA,266,29,237
286878,W00004178,W00004178,Output Areas and Small Areas,OASA,259,38,221
286879,W00004179,W00004179,Output Areas and Small Areas,OASA,236,26,210
286880,W00004180,W00004180,Output Areas and Small Areas,OASA,266,26,240
286881,W00004181,W00004181,Output Areas and Small Areas,OASA,234,26,208
286882,W00004182,W00004182,Output Areas and Small Areas,OASA,267,14,253
286883,W00004183,W00004183,Output Areas and Small Areas,OASA,193,19,174
286884,W00004184,W00004184,Output Areas and Small Areas,OASA,188,15,173
286885,W00004186,W00004186,Output Areas and Small Areas,OASA,224,18,206
286886,W00004188,W00004188,Output Areas and Small Areas,OASA,235,20,215
286887,W00004189,W00004189,Output Areas and Small Areas,OASA,237,15,222
286888,W00004190,W00004190,Output Areas and Small Areas,OASA,239,15,224
286889,W00004191,W00004191,Output Areas and Small Areas,OASA,245,22,223
286890,W00004192,W00004192,Output Areas and Small Areas,OASA,245,12,233
286891,W00004196,W00004196,Output Areas and Small Areas,OASA,201,21,180
286892,W00004197,W00004197,Output Areas and Small Areas,OASA,226,14,212
286893,W00004198,W00004198,Output Areas and Small Areas,OASA,239,12,227
286894,W00004199,W00004199,Output Areas and Small Areas,OASA,269,14,255
286895,W00004200,W00004200,Output Areas and Small Areas,OASA,231,12,219
286896,W00004201,W00004201,Output Areas and Small Areas,OASA,245,16,229
286897,W00004202,W00004202,Output Areas and Small Areas,OASA,289,13,276
286898,W00004203,W00004203,Output Areas and Small Areas,OASA,219,10,209
286899,W00004204,W00004204,Output Areas and Small Areas,OASA,241,16,225
286900,W00004205,W00004205,Output Areas and Small Areas,OASA,244,53,191
286901,W00004206,W00004206,Output Areas and Small Areas,OASA,209,25,184
286902,W00004207,W00004207,Output Areas and Small Areas,OASA,272,28,244
286903,W00004208,W00004208,Output Areas and Small Areas,OASA,119,17,102
286904,W00004209,W00004209,Output Areas and Small Areas,OASA,230,47,183
286905,W00004210,W00004210,Output Areas and Small Areas,OASA,234,36,198
286906,W00004211,W00004211,Output Areas and Small Areas,OASA,254,38,216
286907,W00004212,W00004212,Output Areas and Small Areas,OASA,259,37,222
286908,W00004213,W00004213,Output Areas and Small Areas,OASA,196,37,159
286909,W00004214,W00004214,Output Areas and Small Areas,OASA,349,49,300
286910,W00004215,W00004215,Output Areas and Small Areas,OASA,207,21,186
286911,W00004216,W00004216,Output Areas and Small Areas,OASA,247,35,212
286912,W00004217,W00004217,Output Areas and Small Areas,OASA,192,34,158
286913,W00004218,W00004218,Output Areas and Small Areas,OASA,236,39,197
286914,W00004219,W00004219,Output Areas and Small Areas,OASA,108,19,89
286915,W00004220,W00004220,Output Areas and Small Areas,OASA,301,23,278
286916,W00004221,W00004221,Output Areas and Small Areas,OASA,218,8,210
286917,W00004222,W00004222,Output Areas and Small Areas,OASA,240,6,234
286918,W00004223,W00004223,Output Areas and Small Areas,OASA,235,9,226
286919,W00004224,W00004224,Output Areas and Small Areas,OASA,205,5,200
286920,W00004225,W00004225,Output Areas and Small Areas,OASA,246,9,237
286921,W00004226,W00004226,Output Areas and Small Areas,OASA,208,4,204
286922,W00004227,W00004227,Output Areas and Small Areas,OASA,243,13,230
286923,W00004228,W00004228,Output Areas and Small Areas,OASA,186,6,180
286924,W00004229,W00004229,Output Areas and Small Areas,OASA,276,6,270
286925,W00004230,W00004230,Output Areas and Small Areas,OASA,226,4,222
286926,W00004231,W00004231,Output Areas and Small Areas,OASA,213,16,197
286927,W00004232,W00004232,Output Areas and Small Areas,OASA,240,11,229
286928,W00004233,W00004233,Output Areas and Small Areas,OASA,259,22,237
286929,W00004234,W00004234,Output Areas and Small Areas,OASA,215,10,205
286930,W00004235,W00004235,Output Areas and Small Areas,OASA,258,20,238
286931,W00004236,W00004236,Output Areas and Small Areas,OASA,250,10,240
286932,W00004237,W00004237,Output Areas and Small Areas,OASA,259,10,249
286933,W00004238,W00004238,Output Areas and Small Areas,OASA,229,15,214
286934,W00004239,W00004239,Output Areas and Small Areas,OASA,236,6,230
286935,W00004240,W00004240,Output Areas and Small Areas,OASA,235,6,229
286936,W00004241,W00004241,Output Areas and Small Areas,OASA,228,12,216
286937,W00004242,W00004242,Output Areas and Small Areas,OASA,292,32,260
286938,W00004243,W00004243,Output Areas and Small Areas,OASA,343,29,314
286939,W00004244,W00004244,Output Areas and Small Areas,OASA,211,37,174
286940,W00004245,W00004245,Output Areas and Small Areas,OASA,182,22,160
286941,W00004246,W00004246,Output Areas and Small Areas,OASA,380,65,315
286942,W00004247,W00004247,Output Areas and Small Areas,OASA,130,5,125
286943,W00004248,W00004248,Output Areas and Small Areas,OASA,253,39,214
286944,W00004249,W00004249,Output Areas and Small Areas,OASA,255,54,201
286945,W00004250,W00004250,Output Areas and Small Areas,OASA,233,28,205
286946,W00004251,W00004251,Output Areas and Small Areas,OASA,232,33,199
286947,W00004252,W00004252,Output Areas and Small Areas,OASA,402,59,343
286948,W00004253,W00004253,Output Areas and Small Areas,OASA,230,55,175
286949,W00004254,W00004254,Output Areas and Small Areas,OASA,261,42,219
286950,W00004255,W00004255,Output Areas and Small Areas,OASA,375,97,278
286951,W00004256,W00004256,Output Areas and Small Areas,OASA,479,59,420
286952,W00004257,W00004257,Output Areas and Small Areas,OASA,284,38,246
286953,W00004258,W00004258,Output Areas and Small Areas,OASA,251,24,227
286954,W00004259,W00004259,Output Areas and Small Areas,OASA,300,30,270
286955,W00004260,W00004260,Output Areas and Small Areas,OASA,247,28,219
286956,W00004261,W00004261,Output Areas and Small Areas,OASA,230,25,205
286957,W00004262,W00004262,Output Areas and Small Areas,OASA,288,24,264
286958,W00004263,W00004263,Output Areas and Small Areas,OASA,271,28,243
286959,W00004264,W00004264,Output Areas and Small Areas,OASA,256,22,234
286960,W00004265,W00004265,Output Areas and Small Areas,OASA,220,10,210
286961,W00004266,W00004266,Output Areas and Small Areas,OASA,244,20,224
286962,W00004267,W00004267,Output Areas and Small Areas,OASA,257,9,248
286963,W00004268,W00004268,Output Areas and Small Areas,OASA,221,14,207
286964,W00004269,W00004269,Output Areas and Small Areas,OASA,252,21,231
286965,W00004270,W00004270,Output Areas and Small Areas,OASA,227,32,195
286966,W00004271,W00004271,Output Areas and Small Areas,OASA,245,38,207
286967,W00004272,W00004272,Output Areas and Small Areas,OASA,245,45,200
286968,W00004274,W00004274,Output Areas and Small Areas,OASA,253,29,224
286969,W00004275,W00004275,Output Areas and Small Areas,OASA,272,26,246
286970,W00004276,W00004276,Output Areas and Small Areas,OASA,277,21,256
286971,W00004277,W00004277,Output Areas and Small Areas,OASA,371,26,345
286972,W00004278,W00004278,Output Areas and Small Areas,OASA,230,18,212
286973,W00004279,W00004279,Output Areas and Small Areas,OASA,246,28,218
286974,W00004280,W00004280,Output Areas and Small Areas,OASA,276,37,239
286975,W00004281,W00004281,Output Areas and Small Areas,OASA,248,12,236
286976,W00004282,W00004282,Output Areas and Small Areas,OASA,173,7,166
286977,W00004283,W00004283,Output Areas and Small Areas,OASA,215,14,201
286978,W00004284,W00004284,Output Areas and Small Areas,OASA,284,23,261
286979,W00004285,W00004285,Output Areas and Small Areas,OASA,215,7,208
286980,W00004286,W00004286,Output Areas and Small Areas,OASA,331,16,315
286981,W00004288,W00004288,Output Areas and Small Areas,OASA,260,25,235
286982,W00004289,W00004289,Output Areas and Small Areas,OASA,259,28,231
286983,W00004290,W00004290,Output Areas and Small Areas,OASA,277,14,263
286984,W00004291,W00004291,Output Areas and Small Areas,OASA,264,21,243
286985,W00004292,W00004292,Output Areas and Small Areas,OASA,237,25,212
286986,W00004293,W00004293,Output Areas and Small Areas,OASA,195,27,168
286987,W00004294,W00004294,Output Areas and Small Areas,OASA,281,44,237
286988,W00004295,W00004295,Output Areas and Small Areas,OASA,234,18,216
286989,W00004296,W00004296,Output Areas and Small Areas,OASA,210,13,197
286990,W00004297,W00004297,Output Areas and Small Areas,OASA,310,69,241
286991,W00004298,W00004298,Output Areas and Small Areas,OASA,233,27,206
286992,W00004299,W00004299,Output Areas and Small Areas,OASA,155,17,138
286993,W00004300,W00004300,Output Areas and Small Areas,OASA,460,72,388
286994,W00004301,W00004301,Output Areas and Small Areas,OASA,243,66,177
286995,W00004302,W00004302,Output Areas and Small Areas,OASA,284,99,185
286996,W00004303,W00004303,Output Areas and Small Areas,OASA,280,123,157
286997,W00004304,W00004304,Output Areas and Small Areas,OASA,183,52,131
286998,W00004305,W00004305,Output Areas and Small Areas,OASA,280,98,182
286999,W00004306,W00004306,Output Areas and Small Areas,OASA,259,122,137
287000,W00004307,W00004307,Output Areas and Small Areas,OASA,357,32,325
287001,W00004308,W00004308,Output Areas and Small Areas,OASA,235,17,218
287002,W00004309,W00004309,Output Areas and Small Areas,OASA,206,28,178
287003,W00004310,W00004310,Output Areas and Small Areas,OASA,243,21,222
287004,W00004311,W00004311,Output Areas and Small Areas,OASA,225,24,201
287005,W00004312,W00004312,Output Areas and Small Areas,OASA,222,32,190
287006,W00004313,W00004313,Output Areas and Small Areas,OASA,266,29,237
287007,W00004314,W00004314,Output Areas and Small Areas,OASA,250,27,223
287008,W00004315,W00004315,Output Areas and Small Areas,OASA,231,19,212
287009,W00004316,W00004316,Output Areas and Small Areas,OASA,235,14,221
287010,W00004317,W00004317,Output Areas and Small Areas,OASA,261,12,249
287011,W00004318,W00004318,Output Areas and Small Areas,OASA,213,8,205
287012,W00004320,W00004320,Output Areas and Small Areas,OASA,330,55,275
287013,W00004321,W00004321,Output Areas and Small Areas,OASA,241,22,219
287014,W00004322,W00004322,Output Areas and Small Areas,OASA,236,24,212
287015,W00004323,W00004323,Output Areas and Small Areas,OASA,226,35,191
287016,W00004324,W00004324,Output Areas and Small Areas,OASA,261,27,234
287017,W00004325,W00004325,Output Areas and Small Areas,OASA,240,19,221
287018,W00004326,W00004326,Output Areas and Small Areas,OASA,241,7,234
287019,W00004327,W00004327,Output Areas and Small Areas,OASA,259,27,232
287020,W00004328,W00004328,Output Areas and Small Areas,OASA,285,18,267
287021,W00004329,W00004329,Output Areas and Small Areas,OASA,283,14,269
287022,W00004330,W00004330,Output Areas and Small Areas,OASA,251,18,233
287023,W00004331,W00004331,Output Areas and Small Areas,OASA,241,29,212
287024,W00004332,W00004332,Output Areas and Small Areas,OASA,260,24,236
287025,W00004333,W00004333,Output Areas and Small Areas,OASA,189,14,175
287026,W00004334,W00004334,Output Areas and Small Areas,OASA,200,10,190
287027,W00004335,W00004335,Output Areas and Small Areas,OASA,217,24,193
287028,W00004336,W00004336,Output Areas and Small Areas,OASA,240,15,225
287029,W00004337,W00004337,Output Areas and Small Areas,OASA,246,17,229
287030,W00004338,W00004338,Output Areas and Small Areas,OASA,228,21,207
287031,W00004339,W00004339,Output Areas and Small Areas,OASA,295,21,274
287032,W00004340,W00004340,Output Areas and Small Areas,OASA,253,16,237
287033,W00004341,W00004341,Output Areas and Small Areas,OASA,279,61,218
287034,W00004342,W00004342,Output Areas and Small Areas,OASA,232,23,209
287035,W00004343,W00004343,Output Areas and Small Areas,OASA,237,31,206
287036,W00004344,W00004344,Output Areas and Small Areas,OASA,290,59,231
287037,W00004345,W00004345,Output Areas and Small Areas,OASA,263,30,233
287038,W00004346,W00004346,Output Areas and Small Areas,OASA,250,19,231
287039,W00004347,W00004347,Output Areas and Small Areas,OASA,217,17,200
287040,W00004348,W00004348,Output Areas and Small Areas,OASA,259,27,232
287041,W00004349,W00004349,Output Areas and Small Areas,OASA,233,44,189
287042,W00004350,W00004350,Output Areas and Small Areas,OASA,241,34,207
287043,W00004351,W00004351,Output Areas and Small Areas,OASA,248,26,222
287044,W00004352,W00004352,Output Areas and Small Areas,OASA,275,27,248
287045,W00004353,W00004353,Output Areas and Small Areas,OASA,180,31,149
287046,W00004354,W00004354,Output Areas and Small Areas,OASA,234,24,210
287047,W00004355,W00004355,Output Areas and Small Areas,OASA,229,14,215
287048,W00004356,W00004356,Output Areas and Small Areas,OASA,253,27,226
287049,W00004357,W00004357,Output Areas and Small Areas,OASA,257,20,237
287050,W00004358,W00004358,Output Areas and Small Areas,OASA,191,14,177
287051,W00004359,W00004359,Output Areas and Small Areas,OASA,224,29,195
287052,W00004360,W00004360,Output Areas and Small Areas,OASA,228,16,212
287053,W00004361,W00004361,Output Areas and Small Areas,OASA,174,13,161
287054,W00004362,W00004362,Output Areas and Small Areas,OASA,273,27,246
287055,W00004363,W00004363,Output Areas and Small Areas,OASA,307,56,251
287056,W00004364,W00004364,Output Areas and Small Areas,OASA,242,29,213
287057,W00004365,W00004365,Output Areas and Small Areas,OASA,262,20,242
287058,W00004366,W00004366,Output Areas and Small Areas,OASA,276,29,247
287059,W00004367,W00004367,Output Areas and Small Areas,OASA,241,18,223
287060,W00004368,W00004368,Output Areas and Small Areas,OASA,253,26,227
287061,W00004369,W00004369,Output Areas and Small Areas,OASA,259,23,236
287062,W00004370,W00004370,Output Areas and Small Areas,OASA,273,20,253
287063,W00004371,W00004371,Output Areas and Small Areas,OASA,283,15,268
287064,W00004372,W00004372,Output Areas and Small Areas,OASA,320,20,300
287065,W00004373,W00004373,Output Areas and Small Areas,OASA,241,12,229
287066,W00004374,W00004374,Output Areas and Small Areas,OASA,223,26,197
287067,W00004375,W00004375,Output Areas and Small Areas,OASA,183,11,172
287068,W00004376,W00004376,Output Areas and Small Areas,OASA,180,19,161
287069,W00004377,W00004377,Output Areas and Small Areas,OASA,234,12,222
287070,W00004378,W00004378,Output Areas and Small Areas,OASA,218,5,213
287071,W00004379,W00004379,Output Areas and Small Areas,OASA,275,12,263
287072,W00004380,W00004380,Output Areas and Small Areas,OASA,253,22,231
287073,W00004381,W00004381,Output Areas and Small Areas,OASA,202,9,193
287074,W00004382,W00004382,Output Areas and Small Areas,OASA,248,18,230
287075,W00004383,W00004383,Output Areas and Small Areas,OASA,185,10,175
287076,W00004384,W00004384,Output Areas and Small Areas,OASA,222,14,208
287077,W00004385,W00004385,Output Areas and Small Areas,OASA,213,5,208
287078,W00004386,W00004386,Output Areas and Small Areas,OASA,273,12,261
287079,W00004387,W00004387,Output Areas and Small Areas,OASA,264,20,244
287080,W00004388,W00004388,Output Areas and Small Areas,OASA,257,20,237
287081,W00004389,W00004389,Output Areas and Small Areas,OASA,225,26,199
287082,W00004390,W00004390,Output Areas and Small Areas,OASA,275,25,250
287083,W00004391,W00004391,Output Areas and Small Areas,OASA,256,18,238
287084,W00004392,W00004392,Output Areas and Small Areas,OASA,239,21,218
287085,W00004393,W00004393,Output Areas and Small Areas,OASA,257,39,218
287086,W00004394,W00004394,Output Areas and Small Areas,OASA,241,16,225
287087,W00004395,W00004395,Output Areas and Small Areas,OASA,231,23,208
287088,W00004396,W00004396,Output Areas and Small Areas,OASA,248,20,228
287089,W00004397,W00004397,Output Areas and Small Areas,OASA,266,18,248
287090,W00004398,W00004398,Output Areas and Small Areas,OASA,202,11,191
287091,W00004399,W00004399,Output Areas and Small Areas,OASA,249,14,235
287092,W00004400,W00004400,Output Areas and Small Areas,OASA,223,11,212
287093,W00004401,W00004401,Output Areas and Small Areas,OASA,220,8,212
287094,W00004402,W00004402,Output Areas and Small Areas,OASA,233,18,215
287095,W00004403,W00004403,Output Areas and Small Areas,OASA,259,20,239
287096,W00004404,W00004404,Output Areas and Small Areas,OASA,184,19,165
287097,W00004405,W00004405,Output Areas and Small Areas,OASA,364,33,331
287098,W00004406,W00004406,Output Areas and Small Areas,OASA,252,18,234
287099,W00004407,W00004407,Output Areas and Small Areas,OASA,236,18,218
287100,W00004408,W00004408,Output Areas and Small Areas,OASA,382,29,353
287101,W00004409,W00004409,Output Areas and Small Areas,OASA,222,26,196
287102,W00004410,W00004410,Output Areas and Small Areas,OASA,172,18,154
287103,W00004411,W00004411,Output Areas and Small Areas,OASA,307,31,276
287104,W00004412,W00004412,Output Areas and Small Areas,OASA,212,19,193
287105,W00004413,W00004413,Output Areas and Small Areas,OASA,253,16,237
287106,W00004414,W00004414,Output Areas and Small Areas,OASA,252,19,233
287107,W00004415,W00004415,Output Areas and Small Areas,OASA,209,19,190
287108,W00004416,W00004416,Output Areas and Small Areas,OASA,194,13,181
287109,W00004417,W00004417,Output Areas and Small Areas,OASA,195,20,175
287110,W00004418,W00004418,Output Areas and Small Areas,OASA,206,24,182
287111,W00004419,W00004419,Output Areas and Small Areas,OASA,219,22,197
287112,W00004420,W00004420,Output Areas and Small Areas,OASA,211,15,196
287113,W00004421,W00004421,Output Areas and Small Areas,OASA,254,22,232
287114,W00004422,W00004422,Output Areas and Small Areas,OASA,244,33,211
287115,W00004423,W00004423,Output Areas and Small Areas,OASA,223,22,201
287116,W00004424,W00004424,Output Areas and Small Areas,OASA,240,21,219
287117,W00004425,W00004425,Output Areas and Small Areas,OASA,245,25,220
287118,W00004426,W00004426,Output Areas and Small Areas,OASA,198,12,186
287119,W00004427,W00004427,Output Areas and Small Areas,OASA,223,15,208
287120,W00004428,W00004428,Output Areas and Small Areas,OASA,212,12,200
287121,W00004429,W00004429,Output Areas and Small Areas,OASA,210,32,178
287122,W00004430,W00004430,Output Areas and Small Areas,OASA,291,60,231
287123,W00004431,W00004431,Output Areas and Small Areas,OASA,357,32,325
287124,W00004432,W00004432,Output Areas and Small Areas,OASA,345,37,308
287125,W00004433,W00004433,Output Areas and Small Areas,OASA,225,29,196
287126,W00004434,W00004434,Output Areas and Small Areas,OASA,213,29,184
287127,W00004435,W00004435,Output Areas and Small Areas,OASA,227,33,194
287128,W00004436,W00004436,Output Areas and Small Areas,OASA,234,43,191
287129,W00004437,W00004437,Output Areas and Small Areas,OASA,202,25,177
287130,W00004438,W00004438,Output Areas and Small Areas,OASA,298,22,276
287131,W00004439,W00004439,Output Areas and Small Areas,OASA,231,20,211
287132,W00004440,W00004440,Output Areas and Small Areas,OASA,231,22,209
287133,W00004441,W00004441,Output Areas and Small Areas,OASA,232,6,226
287134,W00004442,W00004442,Output Areas and Small Areas,OASA,268,10,258
287135,W00004443,W00004443,Output Areas and Small Areas,OASA,186,13,173
287136,W00004444,W00004444,Output Areas and Small Areas,OASA,246,4,242
287137,W00004445,W00004445,Output Areas and Small Areas,OASA,242,28,214
287138,W00004446,W00004446,Output Areas and Small Areas,OASA,262,7,255
287139,W00004448,W00004448,Output Areas and Small Areas,OASA,197,6,191
287140,W00004449,W00004449,Output Areas and Small Areas,OASA,322,9,313
287141,W00004450,W00004450,Output Areas and Small Areas,OASA,200,5,195
287142,W00004451,W00004451,Output Areas and Small Areas,OASA,241,21,220
287143,W00004452,W00004452,Output Areas and Small Areas,OASA,205,10,195
287144,W00004453,W00004453,Output Areas and Small Areas,OASA,217,7,210
287145,W00004454,W00004454,Output Areas and Small Areas,OASA,222,20,202
287146,W00004455,W00004455,Output Areas and Small Areas,OASA,247,18,229
287147,W00004456,W00004456,Output Areas and Small Areas,OASA,236,5,231
287148,W00004457,W00004457,Output Areas and Small Areas,OASA,242,7,235
287149,W00004458,W00004458,Output Areas and Small Areas,OASA,261,10,251
287150,W00004459,W00004459,Output Areas and Small Areas,OASA,200,10,190
287151,W00004460,W00004460,Output Areas and Small Areas,OASA,238,6,232
287152,W00004461,W00004461,Output Areas and Small Areas,OASA,206,3,203
287153,W00004462,W00004462,Output Areas and Small Areas,OASA,221,8,213
287154,W00004463,W00004463,Output Areas and Small Areas,OASA,264,12,252
287155,W00004464,W00004464,Output Areas and Small Areas,OASA,234,12,222
287156,W00004465,W00004465,Output Areas and Small Areas,OASA,199,7,192
287157,W00004466,W00004466,Output Areas and Small Areas,OASA,190,11,179
287158,W00004467,W00004467,Output Areas and Small Areas,OASA,203,6,197
287159,W00004468,W00004468,Output Areas and Small Areas,OASA,187,7,180
287160,W00004469,W00004469,Output Areas and Small Areas,OASA,218,8,210
287161,W00004470,W00004470,Output Areas and Small Areas,OASA,204,9,195
287162,W00004471,W00004471,Output Areas and Small Areas,OASA,247,6,241
287163,W00004472,W00004472,Output Areas and Small Areas,OASA,193,7,186
287164,W00004473,W00004473,Output Areas and Small Areas,OASA,227,10,217
287165,W00004474,W00004474,Output Areas and Small Areas,OASA,220,7,213
287166,W00004475,W00004475,Output Areas and Small Areas,OASA,218,13,205
287167,W00004476,W00004476,Output Areas and Small Areas,OASA,192,6,186
287168,W00004477,W00004477,Output Areas and Small Areas,OASA,250,6,244
287169,W00004478,W00004478,Output Areas and Small Areas,OASA,270,8,262
287170,W00004479,W00004479,Output Areas and Small Areas,OASA,264,28,236
287171,W00004481,W00004481,Output Areas and Small Areas,OASA,268,71,197
287172,W00004482,W00004482,Output Areas and Small Areas,OASA,223,23,200
287173,W00004483,W00004483,Output Areas and Small Areas,OASA,253,18,235
287174,W00004484,W00004484,Output Areas and Small Areas,OASA,214,40,174
287175,W00004485,W00004485,Output Areas and Small Areas,OASA,249,48,201
287176,W00004486,W00004486,Output Areas and Small Areas,OASA,331,56,275
287177,W00004487,W00004487,Output Areas and Small Areas,OASA,241,22,219
287178,W00004488,W00004488,Output Areas and Small Areas,OASA,248,23,225
287179,W00004489,W00004489,Output Areas and Small Areas,OASA,261,15,246
287180,W00004490,W00004490,Output Areas and Small Areas,OASA,224,17,207
287181,W00004491,W00004491,Output Areas and Small Areas,OASA,166,9,157
287182,W00004492,W00004492,Output Areas and Small Areas,OASA,187,13,174
287183,W00004493,W00004493,Output Areas and Small Areas,OASA,258,18,240
287184,W00004494,W00004494,Output Areas and Small Areas,OASA,341,26,315
287185,W00004495,W00004495,Output Areas and Small Areas,OASA,310,25,285
287186,W00004496,W00004496,Output Areas and Small Areas,OASA,318,30,288
287187,W00004497,W00004497,Output Areas and Small Areas,OASA,272,51,221
287188,W00004498,W00004498,Output Areas and Small Areas,OASA,325,37,288
287189,W00004499,W00004499,Output Areas and Small Areas,OASA,232,25,207
287190,W00004500,W00004500,Output Areas and Small Areas,OASA,243,22,221
287191,W00004501,W00004501,Output Areas and Small Areas,OASA,242,32,210
287192,W00004502,W00004502,Output Areas and Small Areas,OASA,259,34,225
287193,W00004503,W00004503,Output Areas and Small Areas,OASA,209,30,179
287194,W00004504,W00004504,Output Areas and Small Areas,OASA,258,31,227
287195,W00004505,W00004505,Output Areas and Small Areas,OASA,264,29,235
287196,W00004506,W00004506,Output Areas and Small Areas,OASA,258,25,233
287197,W00004507,W00004507,Output Areas and Small Areas,OASA,209,30,179
287198,W00004508,W00004508,Output Areas and Small Areas,OASA,234,29,205
287199,W00004509,W00004509,Output Areas and Small Areas,OASA,256,27,229
287200,W00004510,W00004510,Output Areas and Small Areas,OASA,299,46,253
287201,W00004511,W00004511,Output Areas and Small Areas,OASA,361,75,286
287202,W00004512,W00004512,Output Areas and Small Areas,OASA,277,52,225
287203,W00004514,W00004514,Output Areas and Small Areas,OASA,290,74,216
287204,W00004515,W00004515,Output Areas and Small Areas,OASA,209,56,153
287205,W00004516,W00004516,Output Areas and Small Areas,OASA,227,43,184
287206,W00004517,W00004517,Output Areas and Small Areas,OASA,251,80,171
287207,W00004518,W00004518,Output Areas and Small Areas,OASA,240,61,179
287208,W00004520,W00004520,Output Areas and Small Areas,OASA,253,50,203
287209,W00004521,W00004521,Output Areas and Small Areas,OASA,176,40,136
287210,W00004522,W00004522,Output Areas and Small Areas,OASA,253,93,160
287211,W00004523,W00004523,Output Areas and Small Areas,OASA,293,84,209
287212,W00004524,W00004524,Output Areas and Small Areas,OASA,239,86,153
287213,W00004525,W00004525,Output Areas and Small Areas,OASA,239,74,165
287214,W00004526,W00004526,Output Areas and Small Areas,OASA,205,73,132
287215,W00004527,W00004527,Output Areas and Small Areas,OASA,351,127,224
287216,W00004528,W00004528,Output Areas and Small Areas,OASA,227,81,146
287217,W00004529,W00004529,Output Areas and Small Areas,OASA,277,100,177
287218,W00004530,W00004530,Output Areas and Small Areas,OASA,264,94,170
287219,W00004531,W00004531,Output Areas and Small Areas,OASA,204,3,201
287220,W00004532,W00004532,Output Areas and Small Areas,OASA,240,6,234
287221,W00004533,W00004533,Output Areas and Small Areas,OASA,230,11,219
287222,W00004534,W00004534,Output Areas and Small Areas,OASA,259,11,248
287223,W00004535,W00004535,Output Areas and Small Areas,OASA,254,6,248
287224,W00004536,W00004536,Output Areas and Small Areas,OASA,249,11,238
287225,W00004537,W00004537,Output Areas and Small Areas,OASA,303,29,274
287226,W00004538,W00004538,Output Areas and Small Areas,OASA,268,10,258
287227,W00004539,W00004539,Output Areas and Small Areas,OASA,237,7,230
287228,W00004540,W00004540,Output Areas and Small Areas,OASA,207,7,200
287229,W00004541,W00004541,Output Areas and Small Areas,OASA,237,12,225
287230,W00004542,W00004542,Output Areas and Small Areas,OASA,230,5,225
287231,W00004543,W00004543,Output Areas and Small Areas,OASA,260,15,245
287232,W00004544,W00004544,Output Areas and Small Areas,OASA,286,9,277
287233,W00004545,W00004545,Output Areas and Small Areas,OASA,234,9,225
287234,W00004546,W00004546,Output Areas and Small Areas,OASA,228,14,214
287235,W00004547,W00004547,Output Areas and Small Areas,OASA,239,10,229
287236,W00004549,W00004549,Output Areas and Small Areas,OASA,213,3,210
287237,W00004550,W00004550,Output Areas and Small Areas,OASA,224,9,215
287238,W00004551,W00004551,Output Areas and Small Areas,OASA,272,13,259
287239,W00004552,W00004552,Output Areas and Small Areas,OASA,251,14,237
287240,W00004553,W00004553,Output Areas and Small Areas,OASA,316,23,293
287241,W00004554,W00004554,Output Areas and Small Areas,OASA,312,15,297
287242,W00004555,W00004555,Output Areas and Small Areas,OASA,244,17,227
287243,W00004556,W00004556,Output Areas and Small Areas,OASA,287,18,269
287244,W00004557,W00004557,Output Areas and Small Areas,OASA,245,29,216
287245,W00004558,W00004558,Output Areas and Small Areas,OASA,258,20,238
287246,W00004559,W00004559,Output Areas and Small Areas,OASA,293,21,272
287247,W00004560,W00004560,Output Areas and Small Areas,OASA,255,30,225
287248,W00004561,W00004561,Output Areas and Small Areas,OASA,163,5,158
287249,W00004562,W00004562,Output Areas and Small Areas,OASA,244,29,215
287250,W00004563,W00004563,Output Areas and Small Areas,OASA,243,20,223
287251,W00004564,W00004564,Output Areas and Small Areas,OASA,184,17,167
287252,W00004565,W00004565,Output Areas and Small Areas,OASA,247,20,227
287253,W00004566,W00004566,Output Areas and Small Areas,OASA,287,22,265
287254,W00004567,W00004567,Output Areas and Small Areas,OASA,151,8,143
287255,W00004568,W00004568,Output Areas and Small Areas,OASA,251,21,230
287256,W00004569,W00004569,Output Areas and Small Areas,OASA,205,15,190
287257,W00004570,W00004570,Output Areas and Small Areas,OASA,205,6,199
287258,W00004571,W00004571,Output Areas and Small Areas,OASA,300,38,262
287259,W00004572,W00004572,Output Areas and Small Areas,OASA,308,28,280
287260,W00004573,W00004573,Output Areas and Small Areas,OASA,188,5,183
287261,W00004574,W00004574,Output Areas and Small Areas,OASA,337,31,306
287262,W00004575,W00004575,Output Areas and Small Areas,OASA,181,11,170
287263,W00004576,W00004576,Output Areas and Small Areas,OASA,270,27,243
287264,W00004577,W00004577,Output Areas and Small Areas,OASA,208,17,191
287265,W00004578,W00004578,Output Areas and Small Areas,OASA,217,8,209
287266,W00004579,W00004579,Output Areas and Small Areas,OASA,209,10,199
287267,W00004580,W00004580,Output Areas and Small Areas,OASA,287,36,251
287268,W00004581,W00004581,Output Areas and Small Areas,OASA,233,27,206
287269,W00004582,W00004582,Output Areas and Small Areas,OASA,267,34,233
287270,W00004583,W00004583,Output Areas and Small Areas,OASA,242,36,206
287271,W00004584,W00004584,Output Areas and Small Areas,OASA,280,29,251
287272,W00004586,W00004586,Output Areas and Small Areas,OASA,294,37,257
287273,W00004587,W00004587,Output Areas and Small Areas,OASA,276,35,241
287274,W00004588,W00004588,Output Areas and Small Areas,OASA,216,22,194
287275,W00004589,W00004589,Output Areas and Small Areas,OASA,190,11,179
287276,W00004590,W00004590,Output Areas and Small Areas,OASA,254,22,232
287277,W00004591,W00004591,Output Areas and Small Areas,OASA,210,16,194
287278,W00004592,W00004592,Output Areas and Small Areas,OASA,220,17,203
287279,W00004593,W00004593,Output Areas and Small Areas,OASA,229,15,214
287280,W00004594,W00004594,Output Areas and Small Areas,OASA,227,19,208
287281,W00004595,W00004595,Output Areas and Small Areas,OASA,217,12,205
287282,W00004596,W00004596,Output Areas and Small Areas,OASA,302,30,272
287283,W00004597,W00004597,Output Areas and Small Areas,OASA,258,23,235
287284,W00004598,W00004598,Output Areas and Small Areas,OASA,268,17,251
287285,W00004599,W00004599,Output Areas and Small Areas,OASA,231,25,206
287286,W00004600,W00004600,Output Areas and Small Areas,OASA,226,2,224
287287,W00004601,W00004601,Output Areas and Small Areas,OASA,211,5,206
287288,W00004602,W00004602,Output Areas and Small Areas,OASA,220,8,212
287289,W00004603,W00004603,Output Areas and Small Areas,OASA,200,6,194
287290,W00004604,W00004604,Output Areas and Small Areas,OASA,241,3,238
287291,W00004605,W00004605,Output Areas and Small Areas,OASA,161,7,154
287292,W00004606,W00004606,Output Areas and Small Areas,OASA,221,8,213
287293,W00004607,W00004607,Output Areas and Small Areas,OASA,258,3,255
287294,W00004608,W00004608,Output Areas and Small Areas,OASA,185,9,176
287295,W00004609,W00004609,Output Areas and Small Areas,OASA,153,5,148
287296,W00004610,W00004610,Output Areas and Small Areas,OASA,248,7,241
287297,W00004611,W00004611,Output Areas and Small Areas,OASA,201,2,199
287298,W00004612,W00004612,Output Areas and Small Areas,OASA,189,8,181
287299,W00004613,W00004613,Output Areas and Small Areas,OASA,188,4,184
287300,W00004614,W00004614,Output Areas and Small Areas,OASA,213,5,208
287301,W00004615,W00004615,Output Areas and Small Areas,OASA,254,11,243
287302,W00004616,W00004616,Output Areas and Small Areas,OASA,209,8,201
287303,W00004617,W00004617,Output Areas and Small Areas,OASA,205,11,194
287304,W00004618,W00004618,Output Areas and Small Areas,OASA,192,9,183
287305,W00004619,W00004619,Output Areas and Small Areas,OASA,223,9,214
287306,W00004620,W00004620,Output Areas and Small Areas,OASA,266,6,260
287307,W00004621,W00004621,Output Areas and Small Areas,OASA,177,8,169
287308,W00004622,W00004622,Output Areas and Small Areas,OASA,233,11,222
287309,W00004623,W00004623,Output Areas and Small Areas,OASA,268,16,252
287310,W00004624,W00004624,Output Areas and Small Areas,OASA,209,10,199
287311,W00004625,W00004625,Output Areas and Small Areas,OASA,225,11,214
287312,W00004626,W00004626,Output Areas and Small Areas,OASA,228,3,225
287313,W00004627,W00004627,Output Areas and Small Areas,OASA,245,8,237
287314,W00004628,W00004628,Output Areas and Small Areas,OASA,221,4,217
287315,W00004629,W00004629,Output Areas and Small Areas,OASA,233,3,230
287316,W00004630,W00004630,Output Areas and Small Areas,OASA,173,13,160
287317,W00004631,W00004631,Output Areas and Small Areas,OASA,260,27,233
287318,W00004632,W00004632,Output Areas and Small Areas,OASA,208,34,174
287319,W00004633,W00004633,Output Areas and Small Areas,OASA,416,33,383
287320,W00004634,W00004634,Output Areas and Small Areas,OASA,359,30,329
287321,W00004635,W00004635,Output Areas and Small Areas,OASA,210,25,185
287322,W00004636,W00004636,Output Areas and Small Areas,OASA,274,28,246
287323,W00004637,W00004637,Output Areas and Small Areas,OASA,290,21,269
287324,W00004638,W00004638,Output Areas and Small Areas,OASA,275,31,244
287325,W00004639,W00004639,Output Areas and Small Areas,OASA,216,28,188
287326,W00004640,W00004640,Output Areas and Small Areas,OASA,275,24,251
287327,W00004641,W00004641,Output Areas and Small Areas,OASA,321,12,309
287328,W00004642,W00004642,Output Areas and Small Areas,OASA,346,31,315
287329,W00004643,W00004643,Output Areas and Small Areas,OASA,348,39,309
287330,W00004644,W00004644,Output Areas and Small Areas,OASA,267,33,234
287331,W00004645,W00004645,Output Areas and Small Areas,OASA,350,23,327
287332,W00004646,W00004646,Output Areas and Small Areas,OASA,488,48,440
287333,W00004647,W00004647,Output Areas and Small Areas,OASA,277,23,254
287334,W00004648,W00004648,Output Areas and Small Areas,OASA,323,29,294
287335,W00004649,W00004649,Output Areas and Small Areas,OASA,338,35,303
287336,W00004650,W00004650,Output Areas and Small Areas,OASA,471,43,428
287337,W00004651,W00004651,Output Areas and Small Areas,OASA,341,31,310
287338,W00004652,W00004652,Output Areas and Small Areas,OASA,333,22,311
287339,W00004653,W00004653,Output Areas and Small Areas,OASA,347,39,308
287340,W00004654,W00004654,Output Areas and Small Areas,OASA,429,37,392
287341,W00004655,W00004655,Output Areas and Small Areas,OASA,438,54,384
287342,W00004656,W00004656,Output Areas and Small Areas,OASA,516,44,472
287343,W00004657,W00004657,Output Areas and Small Areas,OASA,459,34,425
287344,W00004658,W00004658,Output Areas and Small Areas,OASA,439,39,400
287345,W00004659,W00004659,Output Areas and Small Areas,OASA,386,30,356
287346,W00004660,W00004660,Output Areas and Small Areas,OASA,283,20,263
287347,W00004661,W00004661,Output Areas and Small Areas,OASA,366,31,335
287348,W00004662,W00004662,Output Areas and Small Areas,OASA,468,37,431
287349,W00004663,W00004663,Output Areas and Small Areas,OASA,418,33,385
287350,W00004664,W00004664,Output Areas and Small Areas,OASA,417,39,378
287351,W00004665,W00004665,Output Areas and Small Areas,OASA,239,19,220
287352,W00004666,W00004666,Output Areas and Small Areas,OASA,213,15,198
287353,W00004667,W00004667,Output Areas and Small Areas,OASA,446,39,407
287354,W00004668,W00004668,Output Areas and Small Areas,OASA,298,20,278
287355,W00004669,W00004669,Output Areas and Small Areas,OASA,273,27,246
287356,W00004670,W00004670,Output Areas and Small Areas,OASA,238,25,213
287357,W00004671,W00004671,Output Areas and Small Areas,OASA,236,16,220
287358,W00004672,W00004672,Output Areas and Small Areas,OASA,221,20,201
287359,W00004673,W00004673,Output Areas and Small Areas,OASA,253,53,200
287360,W00004674,W00004674,Output Areas and Small Areas,OASA,253,34,219
287361,W00004675,W00004675,Output Areas and Small Areas,OASA,260,33,227
287362,W00004676,W00004676,Output Areas and Small Areas,OASA,243,39,204
287363,W00004677,W00004677,Output Areas and Small Areas,OASA,229,43,186
287364,W00004678,W00004678,Output Areas and Small Areas,OASA,268,42,226
287365,W00004679,W00004679,Output Areas and Small Areas,OASA,248,36,212
287366,W00004680,W00004680,Output Areas and Small Areas,OASA,261,30,231
287367,W00004681,W00004681,Output Areas and Small Areas,OASA,273,44,229
287368,W00004682,W00004682,Output Areas and Small Areas,OASA,247,14,233
287369,W00004683,W00004683,Output Areas and Small Areas,OASA,250,9,241
287370,W00004684,W00004684,Output Areas and Small Areas,OASA,264,13,251
287371,W00004685,W00004685,Output Areas and Small Areas,OASA,238,13,225
287372,W00004686,W00004686,Output Areas and Small Areas,OASA,228,21,207
287373,W00004687,W00004687,Output Areas and Small Areas,OASA,207,15,192
287374,W00004688,W00004688,Output Areas and Small Areas,OASA,180,9,171
287375,W00004689,W00004689,Output Areas and Small Areas,OASA,273,17,256
287376,W00004690,W00004690,Output Areas and Small Areas,OASA,198,17,181
287377,W00004691,W00004691,Output Areas and Small Areas,OASA,216,18,198
287378,W00004692,W00004692,Output Areas and Small Areas,OASA,245,12,233
287379,W00004693,W00004693,Output Areas and Small Areas,OASA,321,33,288
287380,W00004694,W00004694,Output Areas and Small Areas,OASA,224,14,210
287381,W00004695,W00004695,Output Areas and Small Areas,OASA,209,11,198
287382,W00004696,W00004696,Output Areas and Small Areas,OASA,222,12,210
287383,W00004697,W00004697,Output Areas and Small Areas,OASA,204,15,189
287384,W00004698,W00004698,Output Areas and Small Areas,OASA,237,20,217
287385,W00004699,W00004699,Output Areas and Small Areas,OASA,209,3,206
287386,W00004700,W00004700,Output Areas and Small Areas,OASA,202,7,195
287387,W00004701,W00004701,Output Areas and Small Areas,OASA,206,11,195
287388,W00004702,W00004702,Output Areas and Small Areas,OASA,179,10,169
287389,W00004703,W00004703,Output Areas and Small Areas,OASA,182,12,170
287390,W00004704,W00004704,Output Areas and Small Areas,OASA,189,8,181
287391,W00004705,W00004705,Output Areas and Small Areas,OASA,301,32,269
287392,W00004706,W00004706,Output Areas and Small Areas,OASA,331,22,309
287393,W00004707,W00004707,Output Areas and Small Areas,OASA,338,12,326
287394,W00004708,W00004708,Output Areas and Small Areas,OASA,297,13,284
287395,W00004709,W00004709,Output Areas and Small Areas,OASA,254,18,236
287396,W00004710,W00004710,Output Areas and Small Areas,OASA,263,10,253
287397,W00004711,W00004711,Output Areas and Small Areas,OASA,237,18,219
287398,W00004712,W00004712,Output Areas and Small Areas,OASA,241,7,234
287399,W00004713,W00004713,Output Areas and Small Areas,OASA,239,15,224
287400,W00004714,W00004714,Output Areas and Small Areas,OASA,257,10,247
287401,W00004715,W00004715,Output Areas and Small Areas,OASA,236,11,225
287402,W00004716,W00004716,Output Areas and Small Areas,OASA,204,5,199
287403,W00004717,W00004717,Output Areas and Small Areas,OASA,225,13,212
287404,W00004718,W00004718,Output Areas and Small Areas,OASA,263,11,252
287405,W00004719,W00004719,Output Areas and Small Areas,OASA,231,14,217
287406,W00004720,W00004720,Output Areas and Small Areas,OASA,226,13,213
287407,W00004721,W00004721,Output Areas and Small Areas,OASA,264,13,251
287408,W00004722,W00004722,Output Areas and Small Areas,OASA,195,6,189
287409,W00004723,W00004723,Output Areas and Small Areas,OASA,219,18,201
287410,W00004724,W00004724,Output Areas and Small Areas,OASA,229,29,200
287411,W00004725,W00004725,Output Areas and Small Areas,OASA,250,13,237
287412,W00004726,W00004726,Output Areas and Small Areas,OASA,167,20,147
287413,W00004728,W00004728,Output Areas and Small Areas,OASA,251,37,214
287414,W00004729,W00004729,Output Areas and Small Areas,OASA,168,6,162
287415,W00004730,W00004730,Output Areas and Small Areas,OASA,313,36,277
287416,W00004731,W00004731,Output Areas and Small Areas,OASA,265,73,192
287417,W00004732,W00004732,Output Areas and Small Areas,OASA,279,95,184
287418,W00004733,W00004733,Output Areas and Small Areas,OASA,263,59,204
287419,W00004734,W00004734,Output Areas and Small Areas,OASA,310,113,197
287420,W00004735,W00004735,Output Areas and Small Areas,OASA,260,68,192
287421,W00004736,W00004736,Output Areas and Small Areas,OASA,266,57,209
287422,W00004737,W00004737,Output Areas and Small Areas,OASA,257,59,198
287423,W00004738,W00004738,Output Areas and Small Areas,OASA,230,10,220
287424,W00004739,W00004739,Output Areas and Small Areas,OASA,261,11,250
287425,W00004740,W00004740,Output Areas and Small Areas,OASA,223,14,209
287426,W00004741,W00004741,Output Areas and Small Areas,OASA,315,26,289
287427,W00004742,W00004742,Output Areas and Small Areas,OASA,254,14,240
287428,W00004743,W00004743,Output Areas and Small Areas,OASA,250,11,239
287429,W00004744,W00004744,Output Areas and Small Areas,OASA,353,25,328
287430,W00004745,W00004745,Output Areas and Small Areas,OASA,290,22,268
287431,W00004746,W00004746,Output Areas and Small Areas,OASA,242,20,222
287432,W00004747,W00004747,Output Areas and Small Areas,OASA,237,20,217
287433,W00004748,W00004748,Output Areas and Small Areas,OASA,203,5,198
287434,W00004749,W00004749,Output Areas and Small Areas,OASA,237,15,222
287435,W00004750,W00004750,Output Areas and Small Areas,OASA,250,16,234
287436,W00004751,W00004751,Output Areas and Small Areas,OASA,226,21,205
287437,W00004752,W00004752,Output Areas and Small Areas,OASA,283,12,271
287438,W00004753,W00004753,Output Areas and Small Areas,OASA,281,20,261
287439,W00004754,W00004754,Output Areas and Small Areas,OASA,269,26,243
287440,W00004755,W00004755,Output Areas and Small Areas,OASA,241,16,225
287441,W00004756,W00004756,Output Areas and Small Areas,OASA,335,22,313
287442,W00004757,W00004757,Output Areas and Small Areas,OASA,264,18,246
287443,W00004758,W00004758,Output Areas and Small Areas,OASA,219,14,205
287444,W00004759,W00004759,Output Areas and Small Areas,OASA,284,16,268
287445,W00004760,W00004760,Output Areas and Small Areas,OASA,216,31,185
287446,W00004761,W00004761,Output Areas and Small Areas,OASA,252,26,226
287447,W00004762,W00004762,Output Areas and Small Areas,OASA,262,25,237
287448,W00004763,W00004763,Output Areas and Small Areas,OASA,215,22,193
287449,W00004764,W00004764,Output Areas and Small Areas,OASA,234,22,212
287450,W00004765,W00004765,Output Areas and Small Areas,OASA,228,23,205
287451,W00004766,W00004766,Output Areas and Small Areas,OASA,238,35,203
287452,W00004767,W00004767,Output Areas and Small Areas,OASA,158,8,150
287453,W00004768,W00004768,Output Areas and Small Areas,OASA,206,10,196
287454,W00004769,W00004769,Output Areas and Small Areas,OASA,216,12,204
287455,W00004770,W00004770,Output Areas and Small Areas,OASA,256,21,235
287456,W00004771,W00004771,Output Areas and Small Areas,OASA,217,12,205
287457,W00004772,W00004772,Output Areas and Small Areas,OASA,245,17,228
287458,W00004773,W00004773,Output Areas and Small Areas,OASA,217,8,209
287459,W00004774,W00004774,Output Areas and Small Areas,OASA,220,10,210
287460,W00004775,W00004775,Output Areas and Small Areas,OASA,217,11,206
287461,W00004776,W00004776,Output Areas and Small Areas,OASA,240,13,227
287462,W00004777,W00004777,Output Areas and Small Areas,OASA,250,10,240
287463,W00004778,W00004778,Output Areas and Small Areas,OASA,196,4,192
287464,W00004779,W00004779,Output Areas and Small Areas,OASA,216,6,210
287465,W00004780,W00004780,Output Areas and Small Areas,OASA,210,9,201
287466,W00004781,W00004781,Output Areas and Small Areas,OASA,272,20,252
287467,W00004782,W00004782,Output Areas and Small Areas,OASA,277,19,258
287468,W00004783,W00004783,Output Areas and Small Areas,OASA,265,15,250
287469,W00004784,W00004784,Output Areas and Small Areas,OASA,221,7,214
287470,W00004785,W00004785,Output Areas and Small Areas,OASA,259,23,236
287471,W00004786,W00004786,Output Areas and Small Areas,OASA,228,14,214
287472,W00004787,W00004787,Output Areas and Small Areas,OASA,249,12,237
287473,W00004788,W00004788,Output Areas and Small Areas,OASA,258,16,242
287474,W00004789,W00004789,Output Areas and Small Areas,OASA,267,24,243
287475,W00004790,W00004790,Output Areas and Small Areas,OASA,220,24,196
287476,W00004791,W00004791,Output Areas and Small Areas,OASA,248,40,208
287477,W00004792,W00004792,Output Areas and Small Areas,OASA,299,49,250
287478,W00004793,W00004793,Output Areas and Small Areas,OASA,277,27,250
287479,W00004794,W00004794,Output Areas and Small Areas,OASA,240,43,197
287480,W00004795,W00004795,Output Areas and Small Areas,OASA,210,22,188
287481,W00004796,W00004796,Output Areas and Small Areas,OASA,222,48,174
287482,W00004797,W00004797,Output Areas and Small Areas,OASA,230,45,185
287483,W00004798,W00004798,Output Areas and Small Areas,OASA,234,51,183
287484,W00004799,W00004799,Output Areas and Small Areas,OASA,247,35,212
287485,W00004800,W00004800,Output Areas and Small Areas,OASA,211,31,180
287486,W00004801,W00004801,Output Areas and Small Areas,OASA,240,45,195
287487,W00004802,W00004802,Output Areas and Small Areas,OASA,251,32,219
287488,W00004803,W00004803,Output Areas and Small Areas,OASA,289,38,251
287489,W00004804,W00004804,Output Areas and Small Areas,OASA,211,18,193
287490,W00004805,W00004805,Output Areas and Small Areas,OASA,195,18,177
287491,W00004806,W00004806,Output Areas and Small Areas,OASA,207,17,190
287492,W00004807,W00004807,Output Areas and Small Areas,OASA,251,36,215
287493,W00004808,W00004808,Output Areas and Small Areas,OASA,237,35,202
287494,W00004809,W00004809,Output Areas and Small Areas,OASA,342,36,306
287495,W00004810,W00004810,Output Areas and Small Areas,OASA,256,26,230
287496,W00004811,W00004811,Output Areas and Small Areas,OASA,268,40,228
287497,W00004812,W00004812,Output Areas and Small Areas,OASA,245,23,222
287498,W00004813,W00004813,Output Areas and Small Areas,OASA,137,9,128
287499,W00004814,W00004814,Output Areas and Small Areas,OASA,267,36,231
287500,W00004815,W00004815,Output Areas and Small Areas,OASA,233,30,203
287501,W00004816,W00004816,Output Areas and Small Areas,OASA,256,44,212
287502,W00004817,W00004817,Output Areas and Small Areas,OASA,228,40,188
287503,W00004818,W00004818,Output Areas and Small Areas,OASA,255,34,221
287504,W00004819,W00004819,Output Areas and Small Areas,OASA,249,22,227
287505,W00004820,W00004820,Output Areas and Small Areas,OASA,202,14,188
287506,W00004821,W00004821,Output Areas and Small Areas,OASA,257,16,241
287507,W00004822,W00004822,Output Areas and Small Areas,OASA,255,42,213
287508,W00004823,W00004823,Output Areas and Small Areas,OASA,240,18,222
287509,W00004824,W00004824,Output Areas and Small Areas,OASA,325,37,288
287510,W00004825,W00004825,Output Areas and Small Areas,OASA,217,18,199
287511,W00004826,W00004826,Output Areas and Small Areas,OASA,216,32,184
287512,W00004827,W00004827,Output Areas and Small Areas,OASA,268,34,234
287513,W00004828,W00004828,Output Areas and Small Areas,OASA,191,12,179
287514,W00004829,W00004829,Output Areas and Small Areas,OASA,262,23,239
287515,W00004830,W00004830,Output Areas and Small Areas,OASA,233,19,214
287516,W00004831,W00004831,Output Areas and Small Areas,OASA,225,16,209
287517,W00004832,W00004832,Output Areas and Small Areas,OASA,200,11,189
287518,W00004833,W00004833,Output Areas and Small Areas,OASA,422,49,373
287519,W00004834,W00004834,Output Areas and Small Areas,OASA,248,20,228
287520,W00004836,W00004836,Output Areas and Small Areas,OASA,206,27,179
287521,W00004837,W00004837,Output Areas and Small Areas,OASA,210,26,184
287522,W00004838,W00004838,Output Areas and Small Areas,OASA,273,39,234
287523,W00004839,W00004839,Output Areas and Small Areas,OASA,268,36,232
287524,W00004840,W00004840,Output Areas and Small Areas,OASA,242,14,228
287525,W00004841,W00004841,Output Areas and Small Areas,OASA,216,14,202
287526,W00004842,W00004842,Output Areas and Small Areas,OASA,271,28,243
287527,W00004843,W00004843,Output Areas and Small Areas,OASA,226,16,210
287528,W00004844,W00004844,Output Areas and Small Areas,OASA,268,20,248
287529,W00004845,W00004845,Output Areas and Small Areas,OASA,250,18,232
287530,W00004846,W00004846,Output Areas and Small Areas,OASA,212,11,201
287531,W00004847,W00004847,Output Areas and Small Areas,OASA,236,26,210
287532,W00004848,W00004848,Output Areas and Small Areas,OASA,266,10,256
287533,W00004849,W00004849,Output Areas and Small Areas,OASA,243,10,233
287534,W00004850,W00004850,Output Areas and Small Areas,OASA,246,14,232
287535,W00004851,W00004851,Output Areas and Small Areas,OASA,296,27,269
287536,W00004852,W00004852,Output Areas and Small Areas,OASA,303,27,276
287537,W00004853,W00004853,Output Areas and Small Areas,OASA,281,18,263
287538,W00004854,W00004854,Output Areas and Small Areas,OASA,248,21,227
287539,W00004855,W00004855,Output Areas and Small Areas,OASA,247,17,230
287540,W00004856,W00004856,Output Areas and Small Areas,OASA,248,19,229
287541,W00004857,W00004857,Output Areas and Small Areas,OASA,292,41,251
287542,W00004858,W00004858,Output Areas and Small Areas,OASA,264,23,241
287543,W00004859,W00004859,Output Areas and Small Areas,OASA,254,14,240
287544,W00004860,W00004860,Output Areas and Small Areas,OASA,230,16,214
287545,W00004861,W00004861,Output Areas and Small Areas,OASA,217,18,199
287546,W00004862,W00004862,Output Areas and Small Areas,OASA,281,23,258
287547,W00004863,W00004863,Output Areas and Small Areas,OASA,246,22,224
287548,W00004864,W00004864,Output Areas and Small Areas,OASA,260,22,238
287549,W00004865,W00004865,Output Areas and Small Areas,OASA,282,13,269
287550,W00004866,W00004866,Output Areas and Small Areas,OASA,230,23,207
287551,W00004867,W00004867,Output Areas and Small Areas,OASA,251,21,230
287552,W00004868,W00004868,Output Areas and Small Areas,OASA,290,19,271
287553,W00004869,W00004869,Output Areas and Small Areas,OASA,214,16,198
287554,W00004870,W00004870,Output Areas and Small Areas,OASA,255,20,235
287555,W00004871,W00004871,Output Areas and Small Areas,OASA,285,21,264
287556,W00004872,W00004872,Output Areas and Small Areas,OASA,224,19,205
287557,W00004873,W00004873,Output Areas and Small Areas,OASA,235,27,208
287558,W00004874,W00004874,Output Areas and Small Areas,OASA,215,19,196
287559,W00004875,W00004875,Output Areas and Small Areas,OASA,235,24,211
287560,W00004876,W00004876,Output Areas and Small Areas,OASA,368,34,334
287561,W00004877,W00004877,Output Areas and Small Areas,OASA,231,27,204
287562,W00004878,W00004878,Output Areas and Small Areas,OASA,408,50,358
287563,W00004879,W00004879,Output Areas and Small Areas,OASA,290,35,255
287564,W00004880,W00004880,Output Areas and Small Areas,OASA,253,20,233
287565,W00004881,W00004881,Output Areas and Small Areas,OASA,404,28,376
287566,W00004882,W00004882,Output Areas and Small Areas,OASA,224,20,204
287567,W00004883,W00004883,Output Areas and Small Areas,OASA,321,68,253
287568,W00004884,W00004884,Output Areas and Small Areas,OASA,264,78,186
287569,W00004885,W00004885,Output Areas and Small Areas,OASA,248,70,178
287570,W00004886,W00004886,Output Areas and Small Areas,OASA,263,48,215
287571,W00004887,W00004887,Output Areas and Small Areas,OASA,241,52,189
287572,W00004888,W00004888,Output Areas and Small Areas,OASA,260,51,209
287573,W00004889,W00004889,Output Areas and Small Areas,OASA,257,169,88
287574,W00004890,W00004890,Output Areas and Small Areas,OASA,232,137,95
287575,W00004891,W00004891,Output Areas and Small Areas,OASA,247,108,139
287576,W00004892,W00004892,Output Areas and Small Areas,OASA,230,129,101
287577,W00004893,W00004893,Output Areas and Small Areas,OASA,159,3,156
287578,W00004894,W00004894,Output Areas and Small Areas,OASA,256,16,240
287579,W00004895,W00004895,Output Areas and Small Areas,OASA,204,11,193
287580,W00004896,W00004896,Output Areas and Small Areas,OASA,254,10,244
287581,W00004897,W00004897,Output Areas and Small Areas,OASA,286,15,271
287582,W00004898,W00004898,Output Areas and Small Areas,OASA,314,17,297
287583,W00004899,W00004899,Output Areas and Small Areas,OASA,232,12,220
287584,W00004900,W00004900,Output Areas and Small Areas,OASA,166,6,160
287585,W00004901,W00004901,Output Areas and Small Areas,OASA,194,6,188
287586,W00004902,W00004902,Output Areas and Small Areas,OASA,211,8,203
287587,W00004903,W00004903,Output Areas and Small Areas,OASA,279,31,248
287588,W00004904,W00004904,Output Areas and Small Areas,OASA,94,13,81
287589,W00004905,W00004905,Output Areas and Small Areas,OASA,249,20,229
287590,W00004906,W00004906,Output Areas and Small Areas,OASA,203,12,191
287591,W00004907,W00004907,Output Areas and Small Areas,OASA,209,14,195
287592,W00004908,W00004908,Output Areas and Small Areas,OASA,213,16,197
287593,W00004909,W00004909,Output Areas and Small Areas,OASA,238,24,214
287594,W00004910,W00004910,Output Areas and Small Areas,OASA,216,12,204
287595,W00004911,W00004911,Output Areas and Small Areas,OASA,229,23,206
287596,W00004912,W00004912,Output Areas and Small Areas,OASA,228,20,208
287597,W00004913,W00004913,Output Areas and Small Areas,OASA,271,26,245
287598,W00004914,W00004914,Output Areas and Small Areas,OASA,196,19,177
287599,W00004915,W00004915,Output Areas and Small Areas,OASA,190,9,181
287600,W00004916,W00004916,Output Areas and Small Areas,OASA,223,9,214
287601,W00004917,W00004917,Output Areas and Small Areas,OASA,264,17,247
287602,W00004918,W00004918,Output Areas and Small Areas,OASA,226,11,215
287603,W00004919,W00004919,Output Areas and Small Areas,OASA,209,48,161
287604,W00004920,W00004920,Output Areas and Small Areas,OASA,226,42,184
287605,W00004921,W00004921,Output Areas and Small Areas,OASA,233,51,182
287606,W00004922,W00004922,Output Areas and Small Areas,OASA,239,40,199
287607,W00004923,W00004923,Output Areas and Small Areas,OASA,206,38,168
287608,W00004924,W00004924,Output Areas and Small Areas,OASA,225,17,208
287609,W00004925,W00004925,Output Areas and Small Areas,OASA,272,55,217
287610,W00004926,W00004926,Output Areas and Small Areas,OASA,277,66,211
287611,W00004927,W00004927,Output Areas and Small Areas,OASA,252,26,226
287612,W00004928,W00004928,Output Areas and Small Areas,OASA,248,28,220
287613,W00004929,W00004929,Output Areas and Small Areas,OASA,208,39,169
287614,W00004930,W00004930,Output Areas and Small Areas,OASA,259,27,232
287615,W00004931,W00004931,Output Areas and Small Areas,OASA,236,64,172
287616,W00004932,W00004932,Output Areas and Small Areas,OASA,194,70,124
287617,W00004933,W00004933,Output Areas and Small Areas,OASA,338,71,267
287618,W00004934,W00004934,Output Areas and Small Areas,OASA,271,87,184
287619,W00004935,W00004935,Output Areas and Small Areas,OASA,286,73,213
287620,W00004936,W00004936,Output Areas and Small Areas,OASA,237,132,105
287621,W00004937,W00004937,Output Areas and Small Areas,OASA,196,101,95
287622,W00004938,W00004938,Output Areas and Small Areas,OASA,239,127,112
287623,W00004939,W00004939,Output Areas and Small Areas,OASA,235,118,117
287624,W00004940,W00004940,Output Areas and Small Areas,OASA,114,48,66
287625,W00004941,W00004941,Output Areas and Small Areas,OASA,308,186,122
287626,W00004942,W00004942,Output Areas and Small Areas,OASA,160,113,47
287627,W00004943,W00004943,Output Areas and Small Areas,OASA,174,96,78
287628,W00004944,W00004944,Output Areas and Small Areas,OASA,261,154,107
287629,W00004945,W00004945,Output Areas and Small Areas,OASA,222,112,110
287630,W00004946,W00004946,Output Areas and Small Areas,OASA,231,93,138
287631,W00004947,W00004947,Output Areas and Small Areas,OASA,240,11,229
287632,W00004948,W00004948,Output Areas and Small Areas,OASA,185,12,173
287633,W00004949,W00004949,Output Areas and Small Areas,OASA,161,4,157
287634,W00004950,W00004950,Output Areas and Small Areas,OASA,301,19,282
287635,W00004951,W00004951,Output Areas and Small Areas,OASA,234,12,222
287636,W00004952,W00004952,Output Areas and Small Areas,OASA,239,168,71
287637,W00004953,W00004953,Output Areas and Small Areas,OASA,354,163,191
287638,W00004954,W00004954,Output Areas and Small Areas,OASA,224,154,70
287639,W00004955,W00004955,Output Areas and Small Areas,OASA,253,149,104
287640,W00004956,W00004956,Output Areas and Small Areas,OASA,197,11,186
287641,W00004958,W00004958,Output Areas and Small Areas,OASA,288,28,260
287642,W00004960,W00004960,Output Areas and Small Areas,OASA,264,24,240
287643,W00004961,W00004961,Output Areas and Small Areas,OASA,249,18,231
287644,W00004962,W00004962,Output Areas and Small Areas,OASA,242,8,234
287645,W00004963,W00004963,Output Areas and Small Areas,OASA,215,9,206
287646,W00004964,W00004964,Output Areas and Small Areas,OASA,198,8,190
287647,W00004965,W00004965,Output Areas and Small Areas,OASA,263,13,250
287648,W00004966,W00004966,Output Areas and Small Areas,OASA,235,16,219
287649,W00004968,W00004968,Output Areas and Small Areas,OASA,273,10,263
287650,W00004969,W00004969,Output Areas and Small Areas,OASA,224,8,216
287651,W00004970,W00004970,Output Areas and Small Areas,OASA,216,14,202
287652,W00004971,W00004971,Output Areas and Small Areas,OASA,239,17,222
287653,W00004972,W00004972,Output Areas and Small Areas,OASA,223,11,212
287654,W00004973,W00004973,Output Areas and Small Areas,OASA,270,16,254
287655,W00004974,W00004974,Output Areas and Small Areas,OASA,207,6,201
287656,W00004975,W00004975,Output Areas and Small Areas,OASA,225,22,203
287657,W00004976,W00004976,Output Areas and Small Areas,OASA,180,14,166
287658,W00004977,W00004977,Output Areas and Small Areas,OASA,219,13,206
287659,W00004978,W00004978,Output Areas and Small Areas,OASA,195,14,181
287660,W00004979,W00004979,Output Areas and Small Areas,OASA,223,13,210
287661,W00004980,W00004980,Output Areas and Small Areas,OASA,241,18,223
287662,W00004981,W00004981,Output Areas and Small Areas,OASA,230,17,213
287663,W00004982,W00004982,Output Areas and Small Areas,OASA,205,7,198
287664,W00004983,W00004983,Output Areas and Small Areas,OASA,222,9,213
287665,W00004984,W00004984,Output Areas and Small Areas,OASA,201,13,188
287666,W00004985,W00004985,Output Areas and Small Areas,OASA,205,6,199
287667,W00004986,W00004986,Output Areas and Small Areas,OASA,231,11,220
287668,W00004987,W00004987,Output Areas and Small Areas,OASA,223,9,214
287669,W00004988,W00004988,Output Areas and Small Areas,OASA,181,20,161
287670,W00004989,W00004989,Output Areas and Small Areas,OASA,201,9,192
287671,W00004990,W00004990,Output Areas and Small Areas,OASA,208,5,203
287672,W00004991,W00004991,Output Areas and Small Areas,OASA,272,32,240
287673,W00004992,W00004992,Output Areas and Small Areas,OASA,169,13,156
287674,W00004993,W00004993,Output Areas and Small Areas,OASA,225,16,209
287675,W00004994,W00004994,Output Areas and Small Areas,OASA,224,15,209
287676,W00004995,W00004995,Output Areas and Small Areas,OASA,172,12,160
287677,W00004996,W00004996,Output Areas and Small Areas,OASA,213,20,193
287678,W00004997,W00004997,Output Areas and Small Areas,OASA,217,10,207
287679,W00004998,W00004998,Output Areas and Small Areas,OASA,289,27,262
287680,W00004999,W00004999,Output Areas and Small Areas,OASA,260,31,229
287681,W00005000,W00005000,Output Areas and Small Areas,OASA,288,21,267
287682,W00005001,W00005001,Output Areas and Small Areas,OASA,256,13,243
287683,W00005002,W00005002,Output Areas and Small Areas,OASA,246,8,238
287684,W00005003,W00005003,Output Areas and Small Areas,OASA,262,11,251
287685,W00005004,W00005004,Output Areas and Small Areas,OASA,200,10,190
287686,W00005005,W00005005,Output Areas and Small Areas,OASA,251,27,224
287687,W00005006,W00005006,Output Areas and Small Areas,OASA,271,13,258
287688,W00005007,W00005007,Output Areas and Small Areas,OASA,220,11,209
287689,W00005008,W00005008,Output Areas and Small Areas,OASA,245,26,219
287690,W00005009,W00005009,Output Areas and Small Areas,OASA,223,9,214
287691,W00005010,W00005010,Output Areas and Small Areas,OASA,240,23,217
287692,W00005011,W00005011,Output Areas and Small Areas,OASA,246,21,225
287693,W00005012,W00005012,Output Areas and Small Areas,OASA,235,9,226
287694,W00005013,W00005013,Output Areas and Small Areas,OASA,241,15,226
287695,W00005014,W00005014,Output Areas and Small Areas,OASA,226,22,204
287696,W00005015,W00005015,Output Areas and Small Areas,OASA,273,14,259
287697,W00005016,W00005016,Output Areas and Small Areas,OASA,275,14,261
287698,W00005017,W00005017,Output Areas and Small Areas,OASA,209,46,163
287699,W00005018,W00005018,Output Areas and Small Areas,OASA,181,41,140
287700,W00005019,W00005019,Output Areas and Small Areas,OASA,334,46,288
287701,W00005020,W00005020,Output Areas and Small Areas,OASA,267,40,227
287702,W00005021,W00005021,Output Areas and Small Areas,OASA,218,24,194
287703,W00005022,W00005022,Output Areas and Small Areas,OASA,256,18,238
287704,W00005023,W00005023,Output Areas and Small Areas,OASA,227,44,183
287705,W00005024,W00005024,Output Areas and Small Areas,OASA,244,38,206
287706,W00005025,W00005025,Output Areas and Small Areas,OASA,277,65,212
287707,W00005026,W00005026,Output Areas and Small Areas,OASA,272,89,183
287708,W00005027,W00005027,Output Areas and Small Areas,OASA,318,72,246
287709,W00005028,W00005028,Output Areas and Small Areas,OASA,314,79,235
287710,W00005029,W00005029,Output Areas and Small Areas,OASA,356,89,267
287711,W00005030,W00005030,Output Areas and Small Areas,OASA,262,93,169
287712,W00005031,W00005031,Output Areas and Small Areas,OASA,208,48,160
287713,W00005032,W00005032,Output Areas and Small Areas,OASA,305,98,207
287714,W00005033,W00005033,Output Areas and Small Areas,OASA,201,58,143
287715,W00005034,W00005034,Output Areas and Small Areas,OASA,201,70,131
287716,W00005035,W00005035,Output Areas and Small Areas,OASA,236,67,169
287717,W00005036,W00005036,Output Areas and Small Areas,OASA,249,72,177
287718,W00005037,W00005037,Output Areas and Small Areas,OASA,284,106,178
287719,W00005038,W00005038,Output Areas and Small Areas,OASA,269,79,190
287720,W00005039,W00005039,Output Areas and Small Areas,OASA,219,45,174
287721,W00005040,W00005040,Output Areas and Small Areas,OASA,214,46,168
287722,W00005041,W00005041,Output Areas and Small Areas,OASA,255,88,167
287723,W00005042,W00005042,Output Areas and Small Areas,OASA,269,14,255
287724,W00005043,W00005043,Output Areas and Small Areas,OASA,240,7,233
287725,W00005044,W00005044,Output Areas and Small Areas,OASA,241,20,221
287726,W00005045,W00005045,Output Areas and Small Areas,OASA,247,18,229
287727,W00005046,W00005046,Output Areas and Small Areas,OASA,224,16,208
287728,W00005047,W00005047,Output Areas and Small Areas,OASA,251,15,236
287729,W00005048,W00005048,Output Areas and Small Areas,OASA,241,13,228
287730,W00005049,W00005049,Output Areas and Small Areas,OASA,299,13,286
287731,W00005050,W00005050,Output Areas and Small Areas,OASA,266,23,243
287732,W00005051,W00005051,Output Areas and Small Areas,OASA,217,12,205
287733,W00005052,W00005052,Output Areas and Small Areas,OASA,241,13,228
287734,W00005053,W00005053,Output Areas and Small Areas,OASA,401,42,359
287735,W00005054,W00005054,Output Areas and Small Areas,OASA,265,28,237
287736,W00005055,W00005055,Output Areas and Small Areas,OASA,273,17,256
287737,W00005056,W00005056,Output Areas and Small Areas,OASA,236,9,227
287738,W00005057,W00005057,Output Areas and Small Areas,OASA,272,24,248
287739,W00005058,W00005058,Output Areas and Small Areas,OASA,229,19,210
287740,W00005059,W00005059,Output Areas and Small Areas,OASA,277,21,256
287741,W00005060,W00005060,Output Areas and Small Areas,OASA,212,17,195
287742,W00005061,W00005061,Output Areas and Small Areas,OASA,217,18,199
287743,W00005062,W00005062,Output Areas and Small Areas,OASA,237,15,222
287744,W00005063,W00005063,Output Areas and Small Areas,OASA,221,13,208
287745,W00005064,W00005064,Output Areas and Small Areas,OASA,278,15,263
287746,W00005065,W00005065,Output Areas and Small Areas,OASA,236,15,221
287747,W00005066,W00005066,Output Areas and Small Areas,OASA,214,15,199
287748,W00005067,W00005067,Output Areas and Small Areas,OASA,248,32,216
287749,W00005068,W00005068,Output Areas and Small Areas,OASA,246,22,224
287750,W00005069,W00005069,Output Areas and Small Areas,OASA,278,29,249
287751,W00005070,W00005070,Output Areas and Small Areas,OASA,207,34,173
287752,W00005071,W00005071,Output Areas and Small Areas,OASA,218,41,177
287753,W00005072,W00005072,Output Areas and Small Areas,OASA,432,98,334
287754,W00005073,W00005073,Output Areas and Small Areas,OASA,138,43,95
287755,W00005074,W00005074,Output Areas and Small Areas,OASA,207,53,154
287756,W00005075,W00005075,Output Areas and Small Areas,OASA,305,68,237
287757,W00005076,W00005076,Output Areas and Small Areas,OASA,261,56,205
287758,W00005077,W00005077,Output Areas and Small Areas,OASA,214,36,178
287759,W00005078,W00005078,Output Areas and Small Areas,OASA,280,65,215
287760,W00005080,W00005080,Output Areas and Small Areas,OASA,230,10,220
287761,W00005081,W00005081,Output Areas and Small Areas,OASA,329,32,297
287762,W00005082,W00005082,Output Areas and Small Areas,OASA,224,15,209
287763,W00005083,W00005083,Output Areas and Small Areas,OASA,226,8,218
287764,W00005084,W00005084,Output Areas and Small Areas,OASA,255,8,247
287765,W00005085,W00005085,Output Areas and Small Areas,OASA,202,10,192
287766,W00005086,W00005086,Output Areas and Small Areas,OASA,198,10,188
287767,W00005087,W00005087,Output Areas and Small Areas,OASA,198,9,189
287768,W00005088,W00005088,Output Areas and Small Areas,OASA,265,11,254
287769,W00005089,W00005089,Output Areas and Small Areas,OASA,226,11,215
287770,W00005090,W00005090,Output Areas and Small Areas,OASA,227,3,224
287771,W00005091,W00005091,Output Areas and Small Areas,OASA,260,14,246
287772,W00005092,W00005092,Output Areas and Small Areas,OASA,168,3,165
287773,W00005093,W00005093,Output Areas and Small Areas,OASA,262,16,246
287774,W00005094,W00005094,Output Areas and Small Areas,OASA,190,8,182
287775,W00005095,W00005095,Output Areas and Small Areas,OASA,230,10,220
287776,W00005096,W00005096,Output Areas and Small Areas,OASA,208,9,199
287777,W00005097,W00005097,Output Areas and Small Areas,OASA,258,12,246
287778,W00005098,W00005098,Output Areas and Small Areas,OASA,333,19,314
287779,W00005099,W00005099,Output Areas and Small Areas,OASA,236,7,229
287780,W00005100,W00005100,Output Areas and Small Areas,OASA,294,13,281
287781,W00005101,W00005101,Output Areas and Small Areas,OASA,212,4,208
287782,W00005102,W00005102,Output Areas and Small Areas,OASA,231,15,216
287783,W00005103,W00005103,Output Areas and Small Areas,OASA,257,7,250
287784,W00005104,W00005104,Output Areas and Small Areas,OASA,256,13,243
287785,W00005105,W00005105,Output Areas and Small Areas,OASA,216,12,204
287786,W00005106,W00005106,Output Areas and Small Areas,OASA,219,7,212
287787,W00005107,W00005107,Output Areas and Small Areas,OASA,230,16,214
287788,W00005108,W00005108,Output Areas and Small Areas,OASA,207,9,198
287789,W00005109,W00005109,Output Areas and Small Areas,OASA,239,8,231
287790,W00005110,W00005110,Output Areas and Small Areas,OASA,197,3,194
287791,W00005111,W00005111,Output Areas and Small Areas,OASA,213,7,206
287792,W00005112,W00005112,Output Areas and Small Areas,OASA,229,12,217
287793,W00005113,W00005113,Output Areas and Small Areas,OASA,229,11,218
287794,W00005114,W00005114,Output Areas and Small Areas,OASA,237,11,226
287795,W00005115,W00005115,Output Areas and Small Areas,OASA,255,8,247
287796,W00005116,W00005116,Output Areas and Small Areas,OASA,301,15,286
287797,W00005117,W00005117,Output Areas and Small Areas,OASA,239,12,227
287798,W00005118,W00005118,Output Areas and Small Areas,OASA,268,21,247
287799,W00005119,W00005119,Output Areas and Small Areas,OASA,231,11,220
287800,W00005120,W00005120,Output Areas and Small Areas,OASA,224,10,214
287801,W00005121,W00005121,Output Areas and Small Areas,OASA,243,12,231
287802,W00005122,W00005122,Output Areas and Small Areas,OASA,215,8,207
287803,W00005123,W00005123,Output Areas and Small Areas,OASA,240,11,229
287804,W00005124,W00005124,Output Areas and Small Areas,OASA,234,10,224
287805,W00005125,W00005125,Output Areas and Small Areas,OASA,253,39,214
287806,W00005126,W00005126,Output Areas and Small Areas,OASA,243,50,193
287807,W00005127,W00005127,Output Areas and Small Areas,OASA,281,48,233
287808,W00005128,W00005128,Output Areas and Small Areas,OASA,285,38,247
287809,W00005129,W00005129,Output Areas and Small Areas,OASA,186,41,145
287810,W00005130,W00005130,Output Areas and Small Areas,OASA,185,24,161
287811,W00005131,W00005131,Output Areas and Small Areas,OASA,294,82,212
287812,W00005132,W00005132,Output Areas and Small Areas,OASA,269,7,262
287813,W00005133,W00005133,Output Areas and Small Areas,OASA,277,6,271
287814,W00005134,W00005134,Output Areas and Small Areas,OASA,263,16,247
287815,W00005135,W00005135,Output Areas and Small Areas,OASA,338,21,317
287816,W00005136,W00005136,Output Areas and Small Areas,OASA,225,6,219
287817,W00005137,W00005137,Output Areas and Small Areas,OASA,245,21,224
287818,W00005138,W00005138,Output Areas and Small Areas,OASA,325,15,310
287819,W00005139,W00005139,Output Areas and Small Areas,OASA,211,8,203
287820,W00005140,W00005140,Output Areas and Small Areas,OASA,245,8,237
287821,W00005141,W00005141,Output Areas and Small Areas,OASA,219,8,211
287822,W00005142,W00005142,Output Areas and Small Areas,OASA,221,5,216
287823,W00005143,W00005143,Output Areas and Small Areas,OASA,183,9,174
287824,W00005144,W00005144,Output Areas and Small Areas,OASA,234,9,225
287825,W00005145,W00005145,Output Areas and Small Areas,OASA,289,13,276
287826,W00005146,W00005146,Output Areas and Small Areas,OASA,227,15,212
287827,W00005147,W00005147,Output Areas and Small Areas,OASA,217,11,206
287828,W00005148,W00005148,Output Areas and Small Areas,OASA,184,16,168
287829,W00005149,W00005149,Output Areas and Small Areas,OASA,278,33,245
287830,W00005150,W00005150,Output Areas and Small Areas,OASA,254,28,226
287831,W00005151,W00005151,Output Areas and Small Areas,OASA,354,40,314
287832,W00005152,W00005152,Output Areas and Small Areas,OASA,251,23,228
287833,W00005153,W00005153,Output Areas and Small Areas,OASA,296,19,277
287834,W00005154,W00005154,Output Areas and Small Areas,OASA,230,19,211
287835,W00005155,W00005155,Output Areas and Small Areas,OASA,265,22,243
287836,W00005156,W00005156,Output Areas and Small Areas,OASA,217,57,160
287837,W00005157,W00005157,Output Areas and Small Areas,OASA,284,78,206
287838,W00005158,W00005158,Output Areas and Small Areas,OASA,217,63,154
287839,W00005159,W00005159,Output Areas and Small Areas,OASA,218,74,144
287840,W00005160,W00005160,Output Areas and Small Areas,OASA,235,81,154
287841,W00005161,W00005161,Output Areas and Small Areas,OASA,205,107,98
287842,W00005162,W00005162,Output Areas and Small Areas,OASA,250,126,124
287843,W00005163,W00005163,Output Areas and Small Areas,OASA,287,119,168
287844,W00005164,W00005164,Output Areas and Small Areas,OASA,210,104,106
287845,W00005165,W00005165,Output Areas and Small Areas,OASA,200,92,108
287846,W00005166,W00005166,Output Areas and Small Areas,OASA,201,67,134
287847,W00005167,W00005167,Output Areas and Small Areas,OASA,249,112,137
287848,W00005168,W00005168,Output Areas and Small Areas,OASA,199,56,143
287849,W00005169,W00005169,Output Areas and Small Areas,OASA,268,115,153
287850,W00005171,W00005171,Output Areas and Small Areas,OASA,248,80,168
287851,W00005172,W00005172,Output Areas and Small Areas,OASA,164,4,160
287852,W00005173,W00005173,Output Areas and Small Areas,OASA,211,27,184
287853,W00005174,W00005174,Output Areas and Small Areas,OASA,256,17,239
287854,W00005175,W00005175,Output Areas and Small Areas,OASA,304,19,285
287855,W00005176,W00005176,Output Areas and Small Areas,OASA,278,12,266
287856,W00005177,W00005177,Output Areas and Small Areas,OASA,237,12,225
287857,W00005178,W00005178,Output Areas and Small Areas,OASA,256,11,245
287858,W00005179,W00005179,Output Areas and Small Areas,OASA,235,11,224
287859,W00005180,W00005180,Output Areas and Small Areas,OASA,319,14,305
287860,W00005181,W00005181,Output Areas and Small Areas,OASA,305,13,292
287861,W00005182,W00005182,Output Areas and Small Areas,OASA,274,5,269
287862,W00005183,W00005183,Output Areas and Small Areas,OASA,314,12,302
287863,W00005184,W00005184,Output Areas and Small Areas,OASA,274,21,253
287864,W00005185,W00005185,Output Areas and Small Areas,OASA,254,16,238
287865,W00005186,W00005186,Output Areas and Small Areas,OASA,247,8,239
287866,W00005187,W00005187,Output Areas and Small Areas,OASA,379,14,365
287867,W00005188,W00005188,Output Areas and Small Areas,OASA,327,27,300
287868,W00005189,W00005189,Output Areas and Small Areas,OASA,122,10,112
287869,W00005190,W00005190,Output Areas and Small Areas,OASA,187,5,182
287870,W00005191,W00005191,Output Areas and Small Areas,OASA,227,10,217
287871,W00005192,W00005192,Output Areas and Small Areas,OASA,280,12,268
287872,W00005193,W00005193,Output Areas and Small Areas,OASA,254,15,239
287873,W00005194,W00005194,Output Areas and Small Areas,OASA,281,14,267
287874,W00005195,W00005195,Output Areas and Small Areas,OASA,235,15,220
287875,W00005196,W00005196,Output Areas and Small Areas,OASA,239,19,220
287876,W00005197,W00005197,Output Areas and Small Areas,OASA,202,14,188
287877,W00005198,W00005198,Output Areas and Small Areas,OASA,232,13,219
287878,W00005199,W00005199,Output Areas and Small Areas,OASA,280,9,271
287879,W00005201,W00005201,Output Areas and Small Areas,OASA,395,28,367
287880,W00005202,W00005202,Output Areas and Small Areas,OASA,334,30,304
287881,W00005203,W00005203,Output Areas and Small Areas,OASA,252,16,236
287882,W00005204,W00005204,Output Areas and Small Areas,OASA,295,26,269
287883,W00005205,W00005205,Output Areas and Small Areas,OASA,221,11,210
287884,W00005206,W00005206,Output Areas and Small Areas,OASA,200,18,182
287885,W00005207,W00005207,Output Areas and Small Areas,OASA,248,14,234
287886,W00005208,W00005208,Output Areas and Small Areas,OASA,286,14,272
287887,W00005209,W00005209,Output Areas and Small Areas,OASA,270,19,251
287888,W00005211,W00005211,Output Areas and Small Areas,OASA,236,13,223
287889,W00005212,W00005212,Output Areas and Small Areas,OASA,304,35,269
287890,W00005213,W00005213,Output Areas and Small Areas,OASA,284,12,272
287891,W00005214,W00005214,Output Areas and Small Areas,OASA,224,12,212
287892,W00005215,W00005215,Output Areas and Small Areas,OASA,261,16,245
287893,W00005216,W00005216,Output Areas and Small Areas,OASA,187,6,181
287894,W00005217,W00005217,Output Areas and Small Areas,OASA,206,17,189
287895,W00005218,W00005218,Output Areas and Small Areas,OASA,238,14,224
287896,W00005219,W00005219,Output Areas and Small Areas,OASA,189,11,178
287897,W00005220,W00005220,Output Areas and Small Areas,OASA,270,17,253
287898,W00005221,W00005221,Output Areas and Small Areas,OASA,228,8,220
287899,W00005222,W00005222,Output Areas and Small Areas,OASA,215,12,203
287900,W00005223,W00005223,Output Areas and Small Areas,OASA,256,18,238
287901,W00005224,W00005224,Output Areas and Small Areas,OASA,231,8,223
287902,W00005225,W00005225,Output Areas and Small Areas,OASA,199,11,188
287903,W00005226,W00005226,Output Areas and Small Areas,OASA,268,12,256
287904,W00005227,W00005227,Output Areas and Small Areas,OASA,238,16,222
287905,W00005228,W00005228,Output Areas and Small Areas,OASA,176,11,165
287906,W00005229,W00005229,Output Areas and Small Areas,OASA,223,15,208
287907,W00005230,W00005230,Output Areas and Small Areas,OASA,257,13,244
287908,W00005231,W00005231,Output Areas and Small Areas,OASA,176,12,164
287909,W00005232,W00005232,Output Areas and Small Areas,OASA,269,34,235
287910,W00005233,W00005233,Output Areas and Small Areas,OASA,223,29,194
287911,W00005234,W00005234,Output Areas and Small Areas,OASA,145,14,131
287912,W00005235,W00005235,Output Areas and Small Areas,OASA,251,25,226
287913,W00005236,W00005236,Output Areas and Small Areas,OASA,294,15,279
287914,W00005237,W00005237,Output Areas and Small Areas,OASA,346,21,325
287915,W00005238,W00005238,Output Areas and Small Areas,OASA,446,41,405
287916,W00005239,W00005239,Output Areas and Small Areas,OASA,236,10,226
287917,W00005240,W00005240,Output Areas and Small Areas,OASA,242,11,231
287918,W00005241,W00005241,Output Areas and Small Areas,OASA,208,14,194
287919,W00005243,W00005243,Output Areas and Small Areas,OASA,212,9,203
287920,W00005246,W00005246,Output Areas and Small Areas,OASA,254,16,238
287921,W00005247,W00005247,Output Areas and Small Areas,OASA,230,13,217
287922,W00005248,W00005248,Output Areas and Small Areas,OASA,235,16,219
287923,W00005249,W00005249,Output Areas and Small Areas,OASA,218,10,208
287924,W00005250,W00005250,Output Areas and Small Areas,OASA,328,19,309
287925,W00005251,W00005251,Output Areas and Small Areas,OASA,399,28,371
287926,W00005252,W00005252,Output Areas and Small Areas,OASA,224,23,201
287927,W00005253,W00005253,Output Areas and Small Areas,OASA,224,21,203
287928,W00005254,W00005254,Output Areas and Small Areas,OASA,268,38,230
287929,W00005255,W00005255,Output Areas and Small Areas,OASA,219,21,198
287930,W00005256,W00005256,Output Areas and Small Areas,OASA,216,13,203
287931,W00005257,W00005257,Output Areas and Small Areas,OASA,268,19,249
287932,W00005258,W00005258,Output Areas and Small Areas,OASA,208,16,192
287933,W00005259,W00005259,Output Areas and Small Areas,OASA,268,22,246
287934,W00005260,W00005260,Output Areas and Small Areas,OASA,243,19,224
287935,W00005261,W00005261,Output Areas and Small Areas,OASA,227,17,210
287936,W00005262,W00005262,Output Areas and Small Areas,OASA,253,29,224
287937,W00005263,W00005263,Output Areas and Small Areas,OASA,237,20,217
287938,W00005264,W00005264,Output Areas and Small Areas,OASA,204,10,194
287939,W00005265,W00005265,Output Areas and Small Areas,OASA,290,18,272
287940,W00005266,W00005266,Output Areas and Small Areas,OASA,193,8,185
287941,W00005267,W00005267,Output Areas and Small Areas,OASA,223,11,212
287942,W00005268,W00005268,Output Areas and Small Areas,OASA,244,10,234
287943,W00005269,W00005269,Output Areas and Small Areas,OASA,225,9,216
287944,W00005270,W00005270,Output Areas and Small Areas,OASA,243,13,230
287945,W00005271,W00005271,Output Areas and Small Areas,OASA,237,14,223
287946,W00005272,W00005272,Output Areas and Small Areas,OASA,261,12,249
287947,W00005273,W00005273,Output Areas and Small Areas,OASA,203,12,191
287948,W00005274,W00005274,Output Areas and Small Areas,OASA,264,10,254
287949,W00005275,W00005275,Output Areas and Small Areas,OASA,234,23,211
287950,W00005276,W00005276,Output Areas and Small Areas,OASA,203,14,189
287951,W00005277,W00005277,Output Areas and Small Areas,OASA,263,12,251
287952,W00005278,W00005278,Output Areas and Small Areas,OASA,344,31,313
287953,W00005279,W00005279,Output Areas and Small Areas,OASA,205,11,194
287954,W00005280,W00005280,Output Areas and Small Areas,OASA,135,11,124
287955,W00005281,W00005281,Output Areas and Small Areas,OASA,222,6,216
287956,W00005282,W00005282,Output Areas and Small Areas,OASA,203,13,190
287957,W00005283,W00005283,Output Areas and Small Areas,OASA,254,17,237
287958,W00005284,W00005284,Output Areas and Small Areas,OASA,239,16,223
287959,W00005285,W00005285,Output Areas and Small Areas,OASA,225,9,216
287960,W00005287,W00005287,Output Areas and Small Areas,OASA,254,9,245
287961,W00005288,W00005288,Output Areas and Small Areas,OASA,246,9,237
287962,W00005289,W00005289,Output Areas and Small Areas,OASA,223,11,212
287963,W00005291,W00005291,Output Areas and Small Areas,OASA,279,28,251
287964,W00005292,W00005292,Output Areas and Small Areas,OASA,396,32,364
287965,W00005294,W00005294,Output Areas and Small Areas,OASA,237,17,220
287966,W00005295,W00005295,Output Areas and Small Areas,OASA,234,13,221
287967,W00005296,W00005296,Output Areas and Small Areas,OASA,393,31,362
287968,W00005297,W00005297,Output Areas and Small Areas,OASA,233,16,217
287969,W00005298,W00005298,Output Areas and Small Areas,OASA,218,16,202
287970,W00005299,W00005299,Output Areas and Small Areas,OASA,237,11,226
287971,W00005300,W00005300,Output Areas and Small Areas,OASA,158,7,151
287972,W00005301,W00005301,Output Areas and Small Areas,OASA,214,12,202
287973,W00005302,W00005302,Output Areas and Small Areas,OASA,223,11,212
287974,W00005303,W00005303,Output Areas and Small Areas,OASA,243,14,229
287975,W00005304,W00005304,Output Areas and Small Areas,OASA,252,20,232
287976,W00005305,W00005305,Output Areas and Small Areas,OASA,228,17,211
287977,W00005306,W00005306,Output Areas and Small Areas,OASA,245,23,222
287978,W00005307,W00005307,Output Areas and Small Areas,OASA,357,34,323
287979,W00005309,W00005309,Output Areas and Small Areas,OASA,241,24,217
287980,W00005310,W00005310,Output Areas and Small Areas,OASA,279,18,261
287981,W00005311,W00005311,Output Areas and Small Areas,OASA,234,14,220
287982,W00005312,W00005312,Output Areas and Small Areas,OASA,283,14,269
287983,W00005313,W00005313,Output Areas and Small Areas,OASA,229,13,216
287984,W00005314,W00005314,Output Areas and Small Areas,OASA,457,19,438
287985,W00005315,W00005315,Output Areas and Small Areas,OASA,272,29,243
287986,W00005316,W00005316,Output Areas and Small Areas,OASA,241,22,219
287987,W00005317,W00005317,Output Areas and Small Areas,OASA,250,27,223
287988,W00005318,W00005318,Output Areas and Small Areas,OASA,209,17,192
287989,W00005319,W00005319,Output Areas and Small Areas,OASA,266,28,238
287990,W00005320,W00005320,Output Areas and Small Areas,OASA,282,9,273
287991,W00005321,W00005321,Output Areas and Small Areas,OASA,238,15,223
287992,W00005322,W00005322,Output Areas and Small Areas,OASA,190,16,174
287993,W00005324,W00005324,Output Areas and Small Areas,OASA,257,19,238
287994,W00005325,W00005325,Output Areas and Small Areas,OASA,212,32,180
287995,W00005326,W00005326,Output Areas and Small Areas,OASA,184,6,178
287996,W00005327,W00005327,Output Areas and Small Areas,OASA,437,32,405
287997,W00005329,W00005329,Output Areas and Small Areas,OASA,174,9,165
287998,W00005330,W00005330,Output Areas and Small Areas,OASA,285,24,261
287999,W00005331,W00005331,Output Areas and Small Areas,OASA,251,15,236
288000,W00005332,W00005332,Output Areas and Small Areas,OASA,199,17,182
288001,W00005333,W00005333,Output Areas and Small Areas,OASA,262,15,247
288002,W00005334,W00005334,Output Areas and Small Areas,OASA,257,25,232
288003,W00005335,W00005335,Output Areas and Small Areas,OASA,232,11,221
288004,W00005336,W00005336,Output Areas and Small Areas,OASA,205,26,179
288005,W00005337,W00005337,Output Areas and Small Areas,OASA,256,19,237
288006,W00005338,W00005338,Output Areas and Small Areas,OASA,258,23,235
288007,W00005339,W00005339,Output Areas and Small Areas,OASA,227,20,207
288008,W00005340,W00005340,Output Areas and Small Areas,OASA,258,23,235
288009,W00005341,W00005341,Output Areas and Small Areas,OASA,236,12,224
288010,W00005342,W00005342,Output Areas and Small Areas,OASA,260,19,241
288011,W00005343,W00005343,Output Areas and Small Areas,OASA,293,20,273
288012,W00005344,W00005344,Output Areas and Small Areas,OASA,284,32,252
288013,W00005345,W00005345,Output Areas and Small Areas,OASA,273,17,256
288014,W00005346,W00005346,Output Areas and Small Areas,OASA,256,19,237
288015,W00005347,W00005347,Output Areas and Small Areas,OASA,289,11,278
288016,W00005348,W00005348,Output Areas and Small Areas,OASA,213,20,193
288017,W00005349,W00005349,Output Areas and Small Areas,OASA,253,17,236
288018,W00005350,W00005350,Output Areas and Small Areas,OASA,260,13,247
288019,W00005351,W00005351,Output Areas and Small Areas,OASA,290,17,273
288020,W00005352,W00005352,Output Areas and Small Areas,OASA,229,9,220
288021,W00005353,W00005353,Output Areas and Small Areas,OASA,239,8,231
288022,W00005354,W00005354,Output Areas and Small Areas,OASA,169,8,161
288023,W00005355,W00005355,Output Areas and Small Areas,OASA,263,15,248
288024,W00005356,W00005356,Output Areas and Small Areas,OASA,173,9,164
288025,W00005357,W00005357,Output Areas and Small Areas,OASA,223,10,213
288026,W00005358,W00005358,Output Areas and Small Areas,OASA,241,11,230
288027,W00005359,W00005359,Output Areas and Small Areas,OASA,232,20,212
288028,W00005360,W00005360,Output Areas and Small Areas,OASA,230,16,214
288029,W00005361,W00005361,Output Areas and Small Areas,OASA,189,26,163
288030,W00005362,W00005362,Output Areas and Small Areas,OASA,304,33,271
288031,W00005363,W00005363,Output Areas and Small Areas,OASA,247,28,219
288032,W00005364,W00005364,Output Areas and Small Areas,OASA,212,13,199
288033,W00005365,W00005365,Output Areas and Small Areas,OASA,348,59,289
288034,W00005366,W00005366,Output Areas and Small Areas,OASA,214,23,191
288035,W00005367,W00005367,Output Areas and Small Areas,OASA,259,20,239
288036,W00005368,W00005368,Output Areas and Small Areas,OASA,235,31,204
288037,W00005369,W00005369,Output Areas and Small Areas,OASA,260,23,237
288038,W00005370,W00005370,Output Areas and Small Areas,OASA,231,17,214
288039,W00005371,W00005371,Output Areas and Small Areas,OASA,257,18,239
288040,W00005372,W00005372,Output Areas and Small Areas,OASA,231,10,221
288041,W00005373,W00005373,Output Areas and Small Areas,OASA,249,24,225
288042,W00005374,W00005374,Output Areas and Small Areas,OASA,192,13,179
288043,W00005375,W00005375,Output Areas and Small Areas,OASA,227,18,209
288044,W00005376,W00005376,Output Areas and Small Areas,OASA,230,15,215
288045,W00005377,W00005377,Output Areas and Small Areas,OASA,240,21,219
288046,W00005378,W00005378,Output Areas and Small Areas,OASA,230,11,219
288047,W00005379,W00005379,Output Areas and Small Areas,OASA,220,19,201
288048,W00005380,W00005380,Output Areas and Small Areas,OASA,220,22,198
288049,W00005381,W00005381,Output Areas and Small Areas,OASA,243,15,228
288050,W00005382,W00005382,Output Areas and Small Areas,OASA,233,17,216
288051,W00005383,W00005383,Output Areas and Small Areas,OASA,230,18,212
288052,W00005384,W00005384,Output Areas and Small Areas,OASA,243,17,226
288053,W00005385,W00005385,Output Areas and Small Areas,OASA,243,21,222
288054,W00005386,W00005386,Output Areas and Small Areas,OASA,259,28,231
288055,W00005387,W00005387,Output Areas and Small Areas,OASA,229,34,195
288056,W00005388,W00005388,Output Areas and Small Areas,OASA,226,30,196
288057,W00005389,W00005389,Output Areas and Small Areas,OASA,216,33,183
288058,W00005390,W00005390,Output Areas and Small Areas,OASA,165,11,154
288059,W00005391,W00005391,Output Areas and Small Areas,OASA,253,14,239
288060,W00005392,W00005392,Output Areas and Small Areas,OASA,269,34,235
288061,W00005393,W00005393,Output Areas and Small Areas,OASA,236,24,212
288062,W00005394,W00005394,Output Areas and Small Areas,OASA,265,16,249
288063,W00005395,W00005395,Output Areas and Small Areas,OASA,271,35,236
288064,W00005396,W00005396,Output Areas and Small Areas,OASA,213,23,190
288065,W00005397,W00005397,Output Areas and Small Areas,OASA,211,8,203
288066,W00005398,W00005398,Output Areas and Small Areas,OASA,213,20,193
288067,W00005399,W00005399,Output Areas and Small Areas,OASA,236,19,217
288068,W00005400,W00005400,Output Areas and Small Areas,OASA,256,31,225
288069,W00005401,W00005401,Output Areas and Small Areas,OASA,239,14,225
288070,W00005402,W00005402,Output Areas and Small Areas,OASA,263,19,244
288071,W00005403,W00005403,Output Areas and Small Areas,OASA,210,11,199
288072,W00005404,W00005404,Output Areas and Small Areas,OASA,254,27,227
288073,W00005405,W00005405,Output Areas and Small Areas,OASA,260,29,231
288074,W00005406,W00005406,Output Areas and Small Areas,OASA,209,8,201
288075,W00005407,W00005407,Output Areas and Small Areas,OASA,211,8,203
288076,W00005408,W00005408,Output Areas and Small Areas,OASA,198,4,194
288077,W00005409,W00005409,Output Areas and Small Areas,OASA,192,10,182
288078,W00005410,W00005410,Output Areas and Small Areas,OASA,245,21,224
288079,W00005411,W00005411,Output Areas and Small Areas,OASA,399,22,377
288080,W00005412,W00005412,Output Areas and Small Areas,OASA,225,7,218
288081,W00005413,W00005413,Output Areas and Small Areas,OASA,202,9,193
288082,W00005414,W00005414,Output Areas and Small Areas,OASA,240,14,226
288083,W00005415,W00005415,Output Areas and Small Areas,OASA,364,17,347
288084,W00005416,W00005416,Output Areas and Small Areas,OASA,278,17,261
288085,W00005417,W00005417,Output Areas and Small Areas,OASA,209,9,200
288086,W00005418,W00005418,Output Areas and Small Areas,OASA,257,16,241
288087,W00005419,W00005419,Output Areas and Small Areas,OASA,228,19,209
288088,W00005420,W00005420,Output Areas and Small Areas,OASA,230,8,222
288089,W00005421,W00005421,Output Areas and Small Areas,OASA,213,11,202
288090,W00005422,W00005422,Output Areas and Small Areas,OASA,187,5,182
288091,W00005423,W00005423,Output Areas and Small Areas,OASA,248,15,233
288092,W00005424,W00005424,Output Areas and Small Areas,OASA,244,13,231
288093,W00005425,W00005425,Output Areas and Small Areas,OASA,225,11,214
288094,W00005426,W00005426,Output Areas and Small Areas,OASA,272,13,259
288095,W00005427,W00005427,Output Areas and Small Areas,OASA,238,10,228
288096,W00005428,W00005428,Output Areas and Small Areas,OASA,243,10,233
288097,W00005429,W00005429,Output Areas and Small Areas,OASA,271,10,261
288098,W00005430,W00005430,Output Areas and Small Areas,OASA,413,20,393
288099,W00005431,W00005431,Output Areas and Small Areas,OASA,281,7,274
288100,W00005432,W00005432,Output Areas and Small Areas,OASA,251,13,238
288101,W00005433,W00005433,Output Areas and Small Areas,OASA,248,9,239
288102,W00005434,W00005434,Output Areas and Small Areas,OASA,224,20,204
288103,W00005435,W00005435,Output Areas and Small Areas,OASA,216,11,205
288104,W00005436,W00005436,Output Areas and Small Areas,OASA,219,15,204
288105,W00005437,W00005437,Output Areas and Small Areas,OASA,193,11,182
288106,W00005438,W00005438,Output Areas and Small Areas,OASA,215,14,201
288107,W00005439,W00005439,Output Areas and Small Areas,OASA,327,41,286
288108,W00005440,W00005440,Output Areas and Small Areas,OASA,266,28,238
288109,W00005441,W00005441,Output Areas and Small Areas,OASA,238,13,225
288110,W00005442,W00005442,Output Areas and Small Areas,OASA,233,28,205
288111,W00005443,W00005443,Output Areas and Small Areas,OASA,260,20,240
288112,W00005444,W00005444,Output Areas and Small Areas,OASA,233,18,215
288113,W00005445,W00005445,Output Areas and Small Areas,OASA,256,20,236
288114,W00005446,W00005446,Output Areas and Small Areas,OASA,194,6,188
288115,W00005447,W00005447,Output Areas and Small Areas,OASA,289,19,270
288116,W00005448,W00005448,Output Areas and Small Areas,OASA,297,15,282
288117,W00005449,W00005449,Output Areas and Small Areas,OASA,252,27,225
288118,W00005450,W00005450,Output Areas and Small Areas,OASA,265,19,246
288119,W00005451,W00005451,Output Areas and Small Areas,OASA,210,7,203
288120,W00005452,W00005452,Output Areas and Small Areas,OASA,309,13,296
288121,W00005453,W00005453,Output Areas and Small Areas,OASA,257,20,237
288122,W00005454,W00005454,Output Areas and Small Areas,OASA,246,7,239
288123,W00005455,W00005455,Output Areas and Small Areas,OASA,228,8,220
288124,W00005456,W00005456,Output Areas and Small Areas,OASA,269,23,246
288125,W00005457,W00005457,Output Areas and Small Areas,OASA,265,23,242
288126,W00005458,W00005458,Output Areas and Small Areas,OASA,230,16,214
288127,W00005459,W00005459,Output Areas and Small Areas,OASA,259,13,246
288128,W00005460,W00005460,Output Areas and Small Areas,OASA,233,13,220
288129,W00005461,W00005461,Output Areas and Small Areas,OASA,236,11,225
288130,W00005462,W00005462,Output Areas and Small Areas,OASA,205,12,193
288131,W00005463,W00005463,Output Areas and Small Areas,OASA,222,21,201
288132,W00005464,W00005464,Output Areas and Small Areas,OASA,204,20,184
288133,W00005465,W00005465,Output Areas and Small Areas,OASA,248,14,234
288134,W00005466,W00005466,Output Areas and Small Areas,OASA,344,31,313
288135,W00005467,W00005467,Output Areas and Small Areas,OASA,250,12,238
288136,W00005468,W00005468,Output Areas and Small Areas,OASA,240,27,213
288137,W00005469,W00005469,Output Areas and Small Areas,OASA,245,13,232
288138,W00005470,W00005470,Output Areas and Small Areas,OASA,204,15,189
288139,W00005471,W00005471,Output Areas and Small Areas,OASA,180,6,174
288140,W00005472,W00005472,Output Areas and Small Areas,OASA,224,6,218
288141,W00005473,W00005473,Output Areas and Small Areas,OASA,242,14,228
288142,W00005474,W00005474,Output Areas and Small Areas,OASA,199,13,186
288143,W00005475,W00005475,Output Areas and Small Areas,OASA,242,15,227
288144,W00005476,W00005476,Output Areas and Small Areas,OASA,222,7,215
288145,W00005477,W00005477,Output Areas and Small Areas,OASA,246,8,238
288146,W00005478,W00005478,Output Areas and Small Areas,OASA,264,12,252
288147,W00005479,W00005479,Output Areas and Small Areas,OASA,305,14,291
288148,W00005480,W00005480,Output Areas and Small Areas,OASA,100,2,98
288149,W00005481,W00005481,Output Areas and Small Areas,OASA,225,8,217
288150,W00005482,W00005482,Output Areas and Small Areas,OASA,271,11,260
288151,W00005483,W00005483,Output Areas and Small Areas,OASA,237,15,222
288152,W00005484,W00005484,Output Areas and Small Areas,OASA,340,19,321
288153,W00005485,W00005485,Output Areas and Small Areas,OASA,275,26,249
288154,W00005486,W00005486,Output Areas and Small Areas,OASA,234,10,224
288155,W00005487,W00005487,Output Areas and Small Areas,OASA,188,7,181
288156,W00005488,W00005488,Output Areas and Small Areas,OASA,193,8,185
288157,W00005489,W00005489,Output Areas and Small Areas,OASA,206,6,200
288158,W00005490,W00005490,Output Areas and Small Areas,OASA,238,15,223
288159,W00005491,W00005491,Output Areas and Small Areas,OASA,233,24,209
288160,W00005492,W00005492,Output Areas and Small Areas,OASA,297,39,258
288161,W00005493,W00005493,Output Areas and Small Areas,OASA,274,13,261
288162,W00005494,W00005494,Output Areas and Small Areas,OASA,270,23,247
288163,W00005495,W00005495,Output Areas and Small Areas,OASA,246,21,225
288164,W00005496,W00005496,Output Areas and Small Areas,OASA,292,33,259
288165,W00005497,W00005497,Output Areas and Small Areas,OASA,287,35,252
288166,W00005498,W00005498,Output Areas and Small Areas,OASA,242,24,218
288167,W00005499,W00005499,Output Areas and Small Areas,OASA,225,17,208
288168,W00005500,W00005500,Output Areas and Small Areas,OASA,329,19,310
288169,W00005501,W00005501,Output Areas and Small Areas,OASA,286,13,273
288170,W00005502,W00005502,Output Areas and Small Areas,OASA,235,13,222
288171,W00005503,W00005503,Output Areas and Small Areas,OASA,218,10,208
288172,W00005504,W00005504,Output Areas and Small Areas,OASA,229,12,217
288173,W00005505,W00005505,Output Areas and Small Areas,OASA,254,27,227
288174,W00005506,W00005506,Output Areas and Small Areas,OASA,272,28,244
288175,W00005507,W00005507,Output Areas and Small Areas,OASA,237,16,221
288176,W00005508,W00005508,Output Areas and Small Areas,OASA,206,5,201
288177,W00005509,W00005509,Output Areas and Small Areas,OASA,471,37,434
288178,W00005510,W00005510,Output Areas and Small Areas,OASA,174,13,161
288179,W00005511,W00005511,Output Areas and Small Areas,OASA,199,19,180
288180,W00005512,W00005512,Output Areas and Small Areas,OASA,231,15,216
288181,W00005513,W00005513,Output Areas and Small Areas,OASA,100,6,94
288182,W00005514,W00005514,Output Areas and Small Areas,OASA,187,16,171
288183,W00005515,W00005515,Output Areas and Small Areas,OASA,149,8,141
288184,W00005516,W00005516,Output Areas and Small Areas,OASA,347,36,311
288185,W00005517,W00005517,Output Areas and Small Areas,OASA,325,32,293
288186,W00005518,W00005518,Output Areas and Small Areas,OASA,285,37,248
288187,W00005519,W00005519,Output Areas and Small Areas,OASA,316,27,289
288188,W00005520,W00005520,Output Areas and Small Areas,OASA,369,25,344
288189,W00005521,W00005521,Output Areas and Small Areas,OASA,220,20,200
288190,W00005522,W00005522,Output Areas and Small Areas,OASA,276,24,252
288191,W00005523,W00005523,Output Areas and Small Areas,OASA,251,25,226
288192,W00005524,W00005524,Output Areas and Small Areas,OASA,288,20,268
288193,W00005525,W00005525,Output Areas and Small Areas,OASA,205,13,192
288194,W00005526,W00005526,Output Areas and Small Areas,OASA,251,19,232
288195,W00005527,W00005527,Output Areas and Small Areas,OASA,287,19,268
288196,W00005528,W00005528,Output Areas and Small Areas,OASA,220,19,201
288197,W00005529,W00005529,Output Areas and Small Areas,OASA,231,21,210
288198,W00005530,W00005530,Output Areas and Small Areas,OASA,244,16,228
288199,W00005531,W00005531,Output Areas and Small Areas,OASA,275,15,260
288200,W00005532,W00005532,Output Areas and Small Areas,OASA,233,7,226
288201,W00005533,W00005533,Output Areas and Small Areas,OASA,232,3,229
288202,W00005534,W00005534,Output Areas and Small Areas,OASA,266,14,252
288203,W00005535,W00005535,Output Areas and Small Areas,OASA,169,7,162
288204,W00005536,W00005536,Output Areas and Small Areas,OASA,238,12,226
288205,W00005537,W00005537,Output Areas and Small Areas,OASA,274,13,261
288206,W00005538,W00005538,Output Areas and Small Areas,OASA,234,16,218
288207,W00005539,W00005539,Output Areas and Small Areas,OASA,213,14,199
288208,W00005540,W00005540,Output Areas and Small Areas,OASA,231,12,219
288209,W00005541,W00005541,Output Areas and Small Areas,OASA,239,11,228
288210,W00005542,W00005542,Output Areas and Small Areas,OASA,251,15,236
288211,W00005543,W00005543,Output Areas and Small Areas,OASA,236,13,223
288212,W00005544,W00005544,Output Areas and Small Areas,OASA,237,18,219
288213,W00005545,W00005545,Output Areas and Small Areas,OASA,262,18,244
288214,W00005546,W00005546,Output Areas and Small Areas,OASA,265,18,247
288215,W00005547,W00005547,Output Areas and Small Areas,OASA,256,12,244
288216,W00005548,W00005548,Output Areas and Small Areas,OASA,236,18,218
288217,W00005549,W00005549,Output Areas and Small Areas,OASA,265,17,248
288218,W00005550,W00005550,Output Areas and Small Areas,OASA,211,17,194
288219,W00005551,W00005551,Output Areas and Small Areas,OASA,265,18,247
288220,W00005552,W00005552,Output Areas and Small Areas,OASA,202,17,185
288221,W00005553,W00005553,Output Areas and Small Areas,OASA,263,13,250
288222,W00005554,W00005554,Output Areas and Small Areas,OASA,222,21,201
288223,W00005555,W00005555,Output Areas and Small Areas,OASA,248,20,228
288224,W00005556,W00005556,Output Areas and Small Areas,OASA,185,12,173
288225,W00005557,W00005557,Output Areas and Small Areas,OASA,280,20,260
288226,W00005558,W00005558,Output Areas and Small Areas,OASA,246,15,231
288227,W00005559,W00005559,Output Areas and Small Areas,OASA,198,5,193
288228,W00005560,W00005560,Output Areas and Small Areas,OASA,262,11,251
288229,W00005561,W00005561,Output Areas and Small Areas,OASA,255,15,240
288230,W00005562,W00005562,Output Areas and Small Areas,OASA,257,12,245
288231,W00005563,W00005563,Output Areas and Small Areas,OASA,215,8,207
288232,W00005564,W00005564,Output Areas and Small Areas,OASA,186,8,178
288233,W00005565,W00005565,Output Areas and Small Areas,OASA,230,13,217
288234,W00005566,W00005566,Output Areas and Small Areas,OASA,272,16,256
288235,W00005567,W00005567,Output Areas and Small Areas,OASA,263,16,247
288236,W00005568,W00005568,Output Areas and Small Areas,OASA,260,14,246
288237,W00005569,W00005569,Output Areas and Small Areas,OASA,253,15,238
288238,W00005570,W00005570,Output Areas and Small Areas,OASA,232,24,208
288239,W00005571,W00005571,Output Areas and Small Areas,OASA,255,10,245
288240,W00005572,W00005572,Output Areas and Small Areas,OASA,281,17,264
288241,W00005573,W00005573,Output Areas and Small Areas,OASA,294,13,281
288242,W00005574,W00005574,Output Areas and Small Areas,OASA,199,13,186
288243,W00005575,W00005575,Output Areas and Small Areas,OASA,259,17,242
288244,W00005576,W00005576,Output Areas and Small Areas,OASA,310,26,284
288245,W00005577,W00005577,Output Areas and Small Areas,OASA,257,15,242
288246,W00005578,W00005578,Output Areas and Small Areas,OASA,282,27,255
288247,W00005579,W00005579,Output Areas and Small Areas,OASA,269,15,254
288248,W00005580,W00005580,Output Areas and Small Areas,OASA,240,19,221
288249,W00005581,W00005581,Output Areas and Small Areas,OASA,199,11,188
288250,W00005582,W00005582,Output Areas and Small Areas,OASA,208,14,194
288251,W00005583,W00005583,Output Areas and Small Areas,OASA,266,24,242
288252,W00005584,W00005584,Output Areas and Small Areas,OASA,284,32,252
288253,W00005585,W00005585,Output Areas and Small Areas,OASA,294,26,268
288254,W00005586,W00005586,Output Areas and Small Areas,OASA,257,18,239
288255,W00005587,W00005587,Output Areas and Small Areas,OASA,236,18,218
288256,W00005588,W00005588,Output Areas and Small Areas,OASA,231,12,219
288257,W00005589,W00005589,Output Areas and Small Areas,OASA,243,17,226
288258,W00005590,W00005590,Output Areas and Small Areas,OASA,250,13,237
288259,W00005591,W00005591,Output Areas and Small Areas,OASA,314,30,284
288260,W00005592,W00005592,Output Areas and Small Areas,OASA,228,16,212
288261,W00005593,W00005593,Output Areas and Small Areas,OASA,242,12,230
288262,W00005594,W00005594,Output Areas and Small Areas,OASA,276,17,259
288263,W00005595,W00005595,Output Areas and Small Areas,OASA,250,11,239
288264,W00005596,W00005596,Output Areas and Small Areas,OASA,251,27,224
288265,W00005597,W00005597,Output Areas and Small Areas,OASA,275,19,256
288266,W00005598,W00005598,Output Areas and Small Areas,OASA,270,16,254
288267,W00005599,W00005599,Output Areas and Small Areas,OASA,265,14,251
288268,W00005600,W00005600,Output Areas and Small Areas,OASA,217,9,208
288269,W00005601,W00005601,Output Areas and Small Areas,OASA,173,8,165
288270,W00005602,W00005602,Output Areas and Small Areas,OASA,371,30,341
288271,W00005603,W00005603,Output Areas and Small Areas,OASA,305,10,295
288272,W00005604,W00005604,Output Areas and Small Areas,OASA,187,13,174
288273,W00005605,W00005605,Output Areas and Small Areas,OASA,432,31,401
288274,W00005606,W00005606,Output Areas and Small Areas,OASA,376,18,358
288275,W00005608,W00005608,Output Areas and Small Areas,OASA,249,28,221
288276,W00005609,W00005609,Output Areas and Small Areas,OASA,202,25,177
288277,W00005610,W00005610,Output Areas and Small Areas,OASA,198,10,188
288278,W00005611,W00005611,Output Areas and Small Areas,OASA,232,8,224
288279,W00005612,W00005612,Output Areas and Small Areas,OASA,256,35,221
288280,W00005613,W00005613,Output Areas and Small Areas,OASA,219,20,199
288281,W00005614,W00005614,Output Areas and Small Areas,OASA,209,16,193
288282,W00005615,W00005615,Output Areas and Small Areas,OASA,293,26,267
288283,W00005616,W00005616,Output Areas and Small Areas,OASA,298,35,263
288284,W00005617,W00005617,Output Areas and Small Areas,OASA,277,37,240
288285,W00005618,W00005618,Output Areas and Small Areas,OASA,250,30,220
288286,W00005619,W00005619,Output Areas and Small Areas,OASA,226,24,202
288287,W00005620,W00005620,Output Areas and Small Areas,OASA,238,24,214
288288,W00005621,W00005621,Output Areas and Small Areas,OASA,243,22,221
288289,W00005622,W00005622,Output Areas and Small Areas,OASA,258,33,225
288290,W00005623,W00005623,Output Areas and Small Areas,OASA,261,32,229
288291,W00005624,W00005624,Output Areas and Small Areas,OASA,269,20,249
288292,W00005625,W00005625,Output Areas and Small Areas,OASA,252,13,239
288293,W00005626,W00005626,Output Areas and Small Areas,OASA,401,26,375
288294,W00005627,W00005627,Output Areas and Small Areas,OASA,276,37,239
288295,W00005628,W00005628,Output Areas and Small Areas,OASA,211,7,204
288296,W00005629,W00005629,Output Areas and Small Areas,OASA,268,19,249
288297,W00005630,W00005630,Output Areas and Small Areas,OASA,234,13,221
288298,W00005631,W00005631,Output Areas and Small Areas,OASA,303,27,276
288299,W00005632,W00005632,Output Areas and Small Areas,OASA,175,18,157
288300,W00005633,W00005633,Output Areas and Small Areas,OASA,209,25,184
288301,W00005634,W00005634,Output Areas and Small Areas,OASA,256,13,243
288302,W00005635,W00005635,Output Areas and Small Areas,OASA,320,27,293
288303,W00005636,W00005636,Output Areas and Small Areas,OASA,341,22,319
288304,W00005637,W00005637,Output Areas and Small Areas,OASA,242,13,229
288305,W00005638,W00005638,Output Areas and Small Areas,OASA,220,17,203
288306,W00005639,W00005639,Output Areas and Small Areas,OASA,238,16,222
288307,W00005640,W00005640,Output Areas and Small Areas,OASA,243,12,231
288308,W00005641,W00005641,Output Areas and Small Areas,OASA,209,15,194
288309,W00005642,W00005642,Output Areas and Small Areas,OASA,231,16,215
288310,W00005643,W00005643,Output Areas and Small Areas,OASA,224,14,210
288311,W00005644,W00005644,Output Areas and Small Areas,OASA,136,10,126
288312,W00005645,W00005645,Output Areas and Small Areas,OASA,240,15,225
288313,W00005646,W00005646,Output Areas and Small Areas,OASA,249,10,239
288314,W00005647,W00005647,Output Areas and Small Areas,OASA,269,12,257
288315,W00005648,W00005648,Output Areas and Small Areas,OASA,214,6,208
288316,W00005650,W00005650,Output Areas and Small Areas,OASA,276,14,262
288317,W00005651,W00005651,Output Areas and Small Areas,OASA,348,23,325
288318,W00005652,W00005652,Output Areas and Small Areas,OASA,282,21,261
288319,W00005653,W00005653,Output Areas and Small Areas,OASA,162,8,154
288320,W00005654,W00005654,Output Areas and Small Areas,OASA,294,18,276
288321,W00005655,W00005655,Output Areas and Small Areas,OASA,226,13,213
288322,W00005656,W00005656,Output Areas and Small Areas,OASA,225,12,213
288323,W00005657,W00005657,Output Areas and Small Areas,OASA,269,11,258
288324,W00005658,W00005658,Output Areas and Small Areas,OASA,168,3,165
288325,W00005659,W00005659,Output Areas and Small Areas,OASA,289,16,273
288326,W00005660,W00005660,Output Areas and Small Areas,OASA,217,23,194
288327,W00005661,W00005661,Output Areas and Small Areas,OASA,274,16,258
288328,W00005662,W00005662,Output Areas and Small Areas,OASA,222,11,211
288329,W00005663,W00005663,Output Areas and Small Areas,OASA,198,7,191
288330,W00005664,W00005664,Output Areas and Small Areas,OASA,224,14,210
288331,W00005665,W00005665,Output Areas and Small Areas,OASA,280,12,268
288332,W00005666,W00005666,Output Areas and Small Areas,OASA,222,11,211
288333,W00005667,W00005667,Output Areas and Small Areas,OASA,280,18,262
288334,W00005668,W00005668,Output Areas and Small Areas,OASA,237,12,225
288335,W00005669,W00005669,Output Areas and Small Areas,OASA,220,9,211
288336,W00005670,W00005670,Output Areas and Small Areas,OASA,208,18,190
288337,W00005671,W00005671,Output Areas and Small Areas,OASA,248,17,231
288338,W00005672,W00005672,Output Areas and Small Areas,OASA,232,16,216
288339,W00005673,W00005673,Output Areas and Small Areas,OASA,443,22,421
288340,W00005674,W00005674,Output Areas and Small Areas,OASA,177,11,166
288341,W00005675,W00005675,Output Areas and Small Areas,OASA,138,7,131
288342,W00005676,W00005676,Output Areas and Small Areas,OASA,253,17,236
288343,W00005677,W00005677,Output Areas and Small Areas,OASA,174,5,169
288344,W00005678,W00005678,Output Areas and Small Areas,OASA,210,8,202
288345,W00005679,W00005679,Output Areas and Small Areas,OASA,191,15,176
288346,W00005680,W00005680,Output Areas and Small Areas,OASA,278,24,254
288347,W00005681,W00005681,Output Areas and Small Areas,OASA,229,7,222
288348,W00005683,W00005683,Output Areas and Small Areas,OASA,243,11,232
288349,W00005684,W00005684,Output Areas and Small Areas,OASA,229,10,219
288350,W00005686,W00005686,Output Areas and Small Areas,OASA,274,9,265
288351,W00005687,W00005687,Output Areas and Small Areas,OASA,249,17,232
288352,W00005688,W00005688,Output Areas and Small Areas,OASA,195,14,181
288353,W00005689,W00005689,Output Areas and Small Areas,OASA,297,27,270
288354,W00005690,W00005690,Output Areas and Small Areas,OASA,262,20,242
288355,W00005691,W00005691,Output Areas and Small Areas,OASA,219,17,202
288356,W00005692,W00005692,Output Areas and Small Areas,OASA,251,22,229
288357,W00005693,W00005693,Output Areas and Small Areas,OASA,236,25,211
288358,W00005694,W00005694,Output Areas and Small Areas,OASA,216,7,209
288359,W00005695,W00005695,Output Areas and Small Areas,OASA,244,11,233
288360,W00005696,W00005696,Output Areas and Small Areas,OASA,230,18,212
288361,W00005697,W00005697,Output Areas and Small Areas,OASA,222,14,208
288362,W00005698,W00005698,Output Areas and Small Areas,OASA,236,13,223
288363,W00005699,W00005699,Output Areas and Small Areas,OASA,225,15,210
288364,W00005700,W00005700,Output Areas and Small Areas,OASA,205,16,189
288365,W00005701,W00005701,Output Areas and Small Areas,OASA,218,9,209
288366,W00005702,W00005702,Output Areas and Small Areas,OASA,254,24,230
288367,W00005703,W00005703,Output Areas and Small Areas,OASA,289,29,260
288368,W00005704,W00005704,Output Areas and Small Areas,OASA,254,14,240
288369,W00005705,W00005705,Output Areas and Small Areas,OASA,253,10,243
288370,W00005706,W00005706,Output Areas and Small Areas,OASA,209,12,197
288371,W00005707,W00005707,Output Areas and Small Areas,OASA,223,8,215
288372,W00005708,W00005708,Output Areas and Small Areas,OASA,292,17,275
288373,W00005709,W00005709,Output Areas and Small Areas,OASA,231,16,215
288374,W00005710,W00005710,Output Areas and Small Areas,OASA,238,10,228
288375,W00005711,W00005711,Output Areas and Small Areas,OASA,252,20,232
288376,W00005712,W00005712,Output Areas and Small Areas,OASA,237,16,221
288377,W00005713,W00005713,Output Areas and Small Areas,OASA,218,16,202
288378,W00005714,W00005714,Output Areas and Small Areas,OASA,238,10,228
288379,W00005715,W00005715,Output Areas and Small Areas,OASA,213,14,199
288380,W00005716,W00005716,Output Areas and Small Areas,OASA,288,8,280
288381,W00005717,W00005717,Output Areas and Small Areas,OASA,234,16,218
288382,W00005718,W00005718,Output Areas and Small Areas,OASA,281,18,263
288383,W00005719,W00005719,Output Areas and Small Areas,OASA,253,22,231
288384,W00005720,W00005720,Output Areas and Small Areas,OASA,264,32,232
288385,W00005721,W00005721,Output Areas and Small Areas,OASA,190,12,178
288386,W00005722,W00005722,Output Areas and Small Areas,OASA,226,24,202
288387,W00005723,W00005723,Output Areas and Small Areas,OASA,215,29,186
288388,W00005724,W00005724,Output Areas and Small Areas,OASA,212,19,193
288389,W00005725,W00005725,Output Areas and Small Areas,OASA,218,12,206
288390,W00005726,W00005726,Output Areas and Small Areas,OASA,299,26,273
288391,W00005727,W00005727,Output Areas and Small Areas,OASA,242,23,219
288392,W00005728,W00005728,Output Areas and Small Areas,OASA,218,21,197
288393,W00005729,W00005729,Output Areas and Small Areas,OASA,216,20,196
288394,W00005730,W00005730,Output Areas and Small Areas,OASA,215,24,191
288395,W00005731,W00005731,Output Areas and Small Areas,OASA,253,30,223
288396,W00005732,W00005732,Output Areas and Small Areas,OASA,221,16,205
288397,W00005733,W00005733,Output Areas and Small Areas,OASA,253,11,242
288398,W00005734,W00005734,Output Areas and Small Areas,OASA,325,36,289
288399,W00005735,W00005735,Output Areas and Small Areas,OASA,191,17,174
288400,W00005736,W00005736,Output Areas and Small Areas,OASA,412,36,376
288401,W00005737,W00005737,Output Areas and Small Areas,OASA,290,22,268
288402,W00005738,W00005738,Output Areas and Small Areas,OASA,255,27,228
288403,W00005739,W00005739,Output Areas and Small Areas,OASA,259,14,245
288404,W00005740,W00005740,Output Areas and Small Areas,OASA,234,11,223
288405,W00005741,W00005741,Output Areas and Small Areas,OASA,245,15,230
288406,W00005742,W00005742,Output Areas and Small Areas,OASA,247,10,237
288407,W00005743,W00005743,Output Areas and Small Areas,OASA,253,20,233
288408,W00005744,W00005744,Output Areas and Small Areas,OASA,222,10,212
288409,W00005745,W00005745,Output Areas and Small Areas,OASA,279,8,271
288410,W00005746,W00005746,Output Areas and Small Areas,OASA,236,21,215
288411,W00005747,W00005747,Output Areas and Small Areas,OASA,231,22,209
288412,W00005748,W00005748,Output Areas and Small Areas,OASA,255,8,247
288413,W00005749,W00005749,Output Areas and Small Areas,OASA,244,21,223
288414,W00005750,W00005750,Output Areas and Small Areas,OASA,264,14,250
288415,W00005751,W00005751,Output Areas and Small Areas,OASA,272,28,244
288416,W00005752,W00005752,Output Areas and Small Areas,OASA,264,28,236
288417,W00005753,W00005753,Output Areas and Small Areas,OASA,230,16,214
288418,W00005754,W00005754,Output Areas and Small Areas,OASA,259,21,238
288419,W00005755,W00005755,Output Areas and Small Areas,OASA,229,27,202
288420,W00005756,W00005756,Output Areas and Small Areas,OASA,236,12,224
288421,W00005757,W00005757,Output Areas and Small Areas,OASA,275,17,258
288422,W00005758,W00005758,Output Areas and Small Areas,OASA,225,12,213
288423,W00005759,W00005759,Output Areas and Small Areas,OASA,243,16,227
288424,W00005760,W00005760,Output Areas and Small Areas,OASA,282,29,253
288425,W00005761,W00005761,Output Areas and Small Areas,OASA,261,15,246
288426,W00005762,W00005762,Output Areas and Small Areas,OASA,282,22,260
288427,W00005763,W00005763,Output Areas and Small Areas,OASA,261,23,238
288428,W00005764,W00005764,Output Areas and Small Areas,OASA,233,12,221
288429,W00005765,W00005765,Output Areas and Small Areas,OASA,260,21,239
288430,W00005766,W00005766,Output Areas and Small Areas,OASA,260,21,239
288431,W00005767,W00005767,Output Areas and Small Areas,OASA,245,16,229
288432,W00005768,W00005768,Output Areas and Small Areas,OASA,238,22,216
288433,W00005769,W00005769,Output Areas and Small Areas,OASA,313,21,292
288434,W00005770,W00005770,Output Areas and Small Areas,OASA,199,15,184
288435,W00005771,W00005771,Output Areas and Small Areas,OASA,256,14,242
288436,W00005772,W00005772,Output Areas and Small Areas,OASA,327,33,294
288437,W00005773,W00005773,Output Areas and Small Areas,OASA,198,12,186
288438,W00005774,W00005774,Output Areas and Small Areas,OASA,296,27,269
288439,W00005775,W00005775,Output Areas and Small Areas,OASA,224,11,213
288440,W00005776,W00005776,Output Areas and Small Areas,OASA,207,11,196
288441,W00005777,W00005777,Output Areas and Small Areas,OASA,292,25,267
288442,W00005778,W00005778,Output Areas and Small Areas,OASA,282,18,264
288443,W00005779,W00005779,Output Areas and Small Areas,OASA,231,20,211
288444,W00005780,W00005780,Output Areas and Small Areas,OASA,208,14,194
288445,W00005781,W00005781,Output Areas and Small Areas,OASA,262,10,252
288446,W00005782,W00005782,Output Areas and Small Areas,OASA,232,27,205
288447,W00005783,W00005783,Output Areas and Small Areas,OASA,241,11,230
288448,W00005784,W00005784,Output Areas and Small Areas,OASA,325,19,306
288449,W00005785,W00005785,Output Areas and Small Areas,OASA,311,28,283
288450,W00005786,W00005786,Output Areas and Small Areas,OASA,307,9,298
288451,W00005787,W00005787,Output Areas and Small Areas,OASA,230,12,218
288452,W00005788,W00005788,Output Areas and Small Areas,OASA,225,12,213
288453,W00005789,W00005789,Output Areas and Small Areas,OASA,208,11,197
288454,W00005790,W00005790,Output Areas and Small Areas,OASA,250,16,234
288455,W00005791,W00005791,Output Areas and Small Areas,OASA,250,18,232
288456,W00005792,W00005792,Output Areas and Small Areas,OASA,222,11,211
288457,W00005793,W00005793,Output Areas and Small Areas,OASA,227,15,212
288458,W00005794,W00005794,Output Areas and Small Areas,OASA,220,13,207
288459,W00005795,W00005795,Output Areas and Small Areas,OASA,216,9,207
288460,W00005796,W00005796,Output Areas and Small Areas,OASA,286,21,265
288461,W00005797,W00005797,Output Areas and Small Areas,OASA,358,21,337
288462,W00005798,W00005798,Output Areas and Small Areas,OASA,203,3,200
288463,W00005799,W00005799,Output Areas and Small Areas,OASA,227,9,218
288464,W00005800,W00005800,Output Areas and Small Areas,OASA,211,14,197
288465,W00005801,W00005801,Output Areas and Small Areas,OASA,281,30,251
288466,W00005802,W00005802,Output Areas and Small Areas,OASA,228,16,212
288467,W00005803,W00005803,Output Areas and Small Areas,OASA,244,5,239
288468,W00005804,W00005804,Output Areas and Small Areas,OASA,240,18,222
288469,W00005805,W00005805,Output Areas and Small Areas,OASA,220,11,209
288470,W00005806,W00005806,Output Areas and Small Areas,OASA,217,23,194
288471,W00005807,W00005807,Output Areas and Small Areas,OASA,181,11,170
288472,W00005808,W00005808,Output Areas and Small Areas,OASA,255,13,242
288473,W00005809,W00005809,Output Areas and Small Areas,OASA,213,26,187
288474,W00005810,W00005810,Output Areas and Small Areas,OASA,183,12,171
288475,W00005811,W00005811,Output Areas and Small Areas,OASA,213,14,199
288476,W00005812,W00005812,Output Areas and Small Areas,OASA,315,24,291
288477,W00005813,W00005813,Output Areas and Small Areas,OASA,238,22,216
288478,W00005814,W00005814,Output Areas and Small Areas,OASA,250,25,225
288479,W00005815,W00005815,Output Areas and Small Areas,OASA,213,15,198
288480,W00005816,W00005816,Output Areas and Small Areas,OASA,222,17,205
288481,W00005817,W00005817,Output Areas and Small Areas,OASA,286,13,273
288482,W00005818,W00005818,Output Areas and Small Areas,OASA,256,18,238
288483,W00005819,W00005819,Output Areas and Small Areas,OASA,166,18,148
288484,W00005820,W00005820,Output Areas and Small Areas,OASA,260,33,227
288485,W00005821,W00005821,Output Areas and Small Areas,OASA,256,21,235
288486,W00005822,W00005822,Output Areas and Small Areas,OASA,271,17,254
288487,W00005823,W00005823,Output Areas and Small Areas,OASA,256,26,230
288488,W00005824,W00005824,Output Areas and Small Areas,OASA,252,26,226
288489,W00005825,W00005825,Output Areas and Small Areas,OASA,254,11,243
288490,W00005826,W00005826,Output Areas and Small Areas,OASA,235,14,221
288491,W00005827,W00005827,Output Areas and Small Areas,OASA,193,14,179
288492,W00005828,W00005828,Output Areas and Small Areas,OASA,240,11,229
288493,W00005829,W00005829,Output Areas and Small Areas,OASA,238,10,228
288494,W00005830,W00005830,Output Areas and Small Areas,OASA,224,14,210
288495,W00005831,W00005831,Output Areas and Small Areas,OASA,268,12,256
288496,W00005832,W00005832,Output Areas and Small Areas,OASA,253,13,240
288497,W00005833,W00005833,Output Areas and Small Areas,OASA,254,16,238
288498,W00005834,W00005834,Output Areas and Small Areas,OASA,199,9,190
288499,W00005835,W00005835,Output Areas and Small Areas,OASA,234,12,222
288500,W00005836,W00005836,Output Areas and Small Areas,OASA,348,31,317
288501,W00005837,W00005837,Output Areas and Small Areas,OASA,360,53,307
288502,W00005838,W00005838,Output Areas and Small Areas,OASA,265,33,232
288503,W00005839,W00005839,Output Areas and Small Areas,OASA,312,41,271
288504,W00005840,W00005840,Output Areas and Small Areas,OASA,282,26,256
288505,W00005841,W00005841,Output Areas and Small Areas,OASA,375,39,336
288506,W00005842,W00005842,Output Areas and Small Areas,OASA,195,16,179
288507,W00005843,W00005843,Output Areas and Small Areas,OASA,350,21,329
288508,W00005844,W00005844,Output Areas and Small Areas,OASA,197,8,189
288509,W00005845,W00005845,Output Areas and Small Areas,OASA,261,18,243
288510,W00005846,W00005846,Output Areas and Small Areas,OASA,208,5,203
288511,W00005847,W00005847,Output Areas and Small Areas,OASA,346,22,324
288512,W00005848,W00005848,Output Areas and Small Areas,OASA,251,27,224
288513,W00005849,W00005849,Output Areas and Small Areas,OASA,238,17,221
288514,W00005850,W00005850,Output Areas and Small Areas,OASA,265,7,258
288515,W00005851,W00005851,Output Areas and Small Areas,OASA,246,11,235
288516,W00005852,W00005852,Output Areas and Small Areas,OASA,234,7,227
288517,W00005853,W00005853,Output Areas and Small Areas,OASA,176,4,172
288518,W00005854,W00005854,Output Areas and Small Areas,OASA,246,13,233
288519,W00005855,W00005855,Output Areas and Small Areas,OASA,265,22,243
288520,W00005856,W00005856,Output Areas and Small Areas,OASA,259,23,236
288521,W00005857,W00005857,Output Areas and Small Areas,OASA,173,2,171
288522,W00005858,W00005858,Output Areas and Small Areas,OASA,223,15,208
288523,W00005859,W00005859,Output Areas and Small Areas,OASA,227,12,215
288524,W00005860,W00005860,Output Areas and Small Areas,OASA,228,22,206
288525,W00005861,W00005861,Output Areas and Small Areas,OASA,189,16,173
288526,W00005862,W00005862,Output Areas and Small Areas,OASA,285,30,255
288527,W00005863,W00005863,Output Areas and Small Areas,OASA,226,9,217
288528,W00005864,W00005864,Output Areas and Small Areas,OASA,206,15,191
288529,W00005865,W00005865,Output Areas and Small Areas,OASA,255,12,243
288530,W00005866,W00005866,Output Areas and Small Areas,OASA,255,30,225
288531,W00005867,W00005867,Output Areas and Small Areas,OASA,250,27,223
288532,W00005868,W00005868,Output Areas and Small Areas,OASA,204,19,185
288533,W00005869,W00005869,Output Areas and Small Areas,OASA,246,15,231
288534,W00005870,W00005870,Output Areas and Small Areas,OASA,225,9,216
288535,W00005871,W00005871,Output Areas and Small Areas,OASA,223,19,204
288536,W00005872,W00005872,Output Areas and Small Areas,OASA,233,6,227
288537,W00005873,W00005873,Output Areas and Small Areas,OASA,251,7,244
288538,W00005874,W00005874,Output Areas and Small Areas,OASA,212,24,188
288539,W00005875,W00005875,Output Areas and Small Areas,OASA,219,10,209
288540,W00005876,W00005876,Output Areas and Small Areas,OASA,224,14,210
288541,W00005878,W00005878,Output Areas and Small Areas,OASA,377,28,349
288542,W00005879,W00005879,Output Areas and Small Areas,OASA,358,29,329
288543,W00005880,W00005880,Output Areas and Small Areas,OASA,191,15,176
288544,W00005881,W00005881,Output Areas and Small Areas,OASA,150,13,137
288545,W00005882,W00005882,Output Areas and Small Areas,OASA,341,24,317
288546,W00005883,W00005883,Output Areas and Small Areas,OASA,402,46,356
288547,W00005884,W00005884,Output Areas and Small Areas,OASA,252,15,237
288548,W00005885,W00005885,Output Areas and Small Areas,OASA,273,19,254
288549,W00005886,W00005886,Output Areas and Small Areas,OASA,244,22,222
288550,W00005887,W00005887,Output Areas and Small Areas,OASA,277,28,249
288551,W00005888,W00005888,Output Areas and Small Areas,OASA,267,35,232
288552,W00005889,W00005889,Output Areas and Small Areas,OASA,272,26,246
288553,W00005890,W00005890,Output Areas and Small Areas,OASA,316,22,294
288554,W00005891,W00005891,Output Areas and Small Areas,OASA,441,38,403
288555,W00005892,W00005892,Output Areas and Small Areas,OASA,275,24,251
288556,W00005894,W00005894,Output Areas and Small Areas,OASA,259,23,236
288557,W00005895,W00005895,Output Areas and Small Areas,OASA,280,31,249
288558,W00005896,W00005896,Output Areas and Small Areas,OASA,242,19,223
288559,W00005897,W00005897,Output Areas and Small Areas,OASA,270,25,245
288560,W00005898,W00005898,Output Areas and Small Areas,OASA,260,12,248
288561,W00005899,W00005899,Output Areas and Small Areas,OASA,239,16,223
288562,W00005900,W00005900,Output Areas and Small Areas,OASA,299,21,278
288563,W00005901,W00005901,Output Areas and Small Areas,OASA,294,34,260
288564,W00005902,W00005902,Output Areas and Small Areas,OASA,252,16,236
288565,W00005903,W00005903,Output Areas and Small Areas,OASA,314,21,293
288566,W00005904,W00005904,Output Areas and Small Areas,OASA,466,30,436
288567,W00005905,W00005905,Output Areas and Small Areas,OASA,166,11,155
288568,W00005906,W00005906,Output Areas and Small Areas,OASA,320,23,297
288569,W00005907,W00005907,Output Areas and Small Areas,OASA,270,16,254
288570,W00005908,W00005908,Output Areas and Small Areas,OASA,223,8,215
288571,W00005909,W00005909,Output Areas and Small Areas,OASA,260,20,240
288572,W00005910,W00005910,Output Areas and Small Areas,OASA,226,15,211
288573,W00005911,W00005911,Output Areas and Small Areas,OASA,218,15,203
288574,W00005913,W00005913,Output Areas and Small Areas,OASA,271,23,248
288575,W00005914,W00005914,Output Areas and Small Areas,OASA,314,17,297
288576,W00005915,W00005915,Output Areas and Small Areas,OASA,251,14,237
288577,W00005916,W00005916,Output Areas and Small Areas,OASA,238,15,223
288578,W00005917,W00005917,Output Areas and Small Areas,OASA,245,18,227
288579,W00005918,W00005918,Output Areas and Small Areas,OASA,245,16,229
288580,W00005919,W00005919,Output Areas and Small Areas,OASA,257,8,249
288581,W00005920,W00005920,Output Areas and Small Areas,OASA,343,18,325
288582,W00005921,W00005921,Output Areas and Small Areas,OASA,249,11,238
288583,W00005922,W00005922,Output Areas and Small Areas,OASA,213,12,201
288584,W00005924,W00005924,Output Areas and Small Areas,OASA,219,16,203
288585,W00005925,W00005925,Output Areas and Small Areas,OASA,231,8,223
288586,W00005926,W00005926,Output Areas and Small Areas,OASA,207,7,200
288587,W00005927,W00005927,Output Areas and Small Areas,OASA,285,14,271
288588,W00005928,W00005928,Output Areas and Small Areas,OASA,288,16,272
288589,W00005929,W00005929,Output Areas and Small Areas,OASA,240,22,218
288590,W00005930,W00005930,Output Areas and Small Areas,OASA,199,9,190
288591,W00005931,W00005931,Output Areas and Small Areas,OASA,233,26,207
288592,W00005933,W00005933,Output Areas and Small Areas,OASA,229,17,212
288593,W00005934,W00005934,Output Areas and Small Areas,OASA,253,14,239
288594,W00005935,W00005935,Output Areas and Small Areas,OASA,240,19,221
288595,W00005936,W00005936,Output Areas and Small Areas,OASA,264,22,242
288596,W00005937,W00005937,Output Areas and Small Areas,OASA,161,12,149
288597,W00005938,W00005938,Output Areas and Small Areas,OASA,208,21,187
288598,W00005939,W00005939,Output Areas and Small Areas,OASA,232,22,210
288599,W00005940,W00005940,Output Areas and Small Areas,OASA,217,6,211
288600,W00005941,W00005941,Output Areas and Small Areas,OASA,301,19,282
288601,W00005942,W00005942,Output Areas and Small Areas,OASA,228,21,207
288602,W00005943,W00005943,Output Areas and Small Areas,OASA,242,24,218
288603,W00005944,W00005944,Output Areas and Small Areas,OASA,213,21,192
288604,W00005945,W00005945,Output Areas and Small Areas,OASA,247,24,223
288605,W00005946,W00005946,Output Areas and Small Areas,OASA,296,27,269
288606,W00005947,W00005947,Output Areas and Small Areas,OASA,282,18,264
288607,W00005948,W00005948,Output Areas and Small Areas,OASA,231,26,205
288608,W00005949,W00005949,Output Areas and Small Areas,OASA,224,24,200
288609,W00005950,W00005950,Output Areas and Small Areas,OASA,223,16,207
288610,W00005951,W00005951,Output Areas and Small Areas,OASA,334,18,316
288611,W00005952,W00005952,Output Areas and Small Areas,OASA,261,23,238
288612,W00005953,W00005953,Output Areas and Small Areas,OASA,261,24,237
288613,W00005954,W00005954,Output Areas and Small Areas,OASA,252,15,237
288614,W00005955,W00005955,Output Areas and Small Areas,OASA,244,28,216
288615,W00005956,W00005956,Output Areas and Small Areas,OASA,291,25,266
288616,W00005957,W00005957,Output Areas and Small Areas,OASA,289,22,267
288617,W00005958,W00005958,Output Areas and Small Areas,OASA,299,27,272
288618,W00005959,W00005959,Output Areas and Small Areas,OASA,275,20,255
288619,W00005960,W00005960,Output Areas and Small Areas,OASA,242,19,223
288620,W00005961,W00005961,Output Areas and Small Areas,OASA,244,23,221
288621,W00005962,W00005962,Output Areas and Small Areas,OASA,466,41,425
288622,W00005963,W00005963,Output Areas and Small Areas,OASA,254,18,236
288623,W00005964,W00005964,Output Areas and Small Areas,OASA,201,16,185
288624,W00005965,W00005965,Output Areas and Small Areas,OASA,257,9,248
288625,W00005966,W00005966,Output Areas and Small Areas,OASA,218,10,208
288626,W00005967,W00005967,Output Areas and Small Areas,OASA,269,24,245
288627,W00005968,W00005968,Output Areas and Small Areas,OASA,232,31,201
288628,W00005969,W00005969,Output Areas and Small Areas,OASA,312,15,297
288629,W00005970,W00005970,Output Areas and Small Areas,OASA,257,25,232
288630,W00005971,W00005971,Output Areas and Small Areas,OASA,248,24,224
288631,W00005972,W00005972,Output Areas and Small Areas,OASA,269,19,250
288632,W00005973,W00005973,Output Areas and Small Areas,OASA,198,6,192
288633,W00005975,W00005975,Output Areas and Small Areas,OASA,203,16,187
288634,W00005976,W00005976,Output Areas and Small Areas,OASA,283,14,269
288635,W00005977,W00005977,Output Areas and Small Areas,OASA,223,14,209
288636,W00005978,W00005978,Output Areas and Small Areas,OASA,230,16,214
288637,W00005979,W00005979,Output Areas and Small Areas,OASA,207,6,201
288638,W00005980,W00005980,Output Areas and Small Areas,OASA,226,12,214
288639,W00005981,W00005981,Output Areas and Small Areas,OASA,317,28,289
288640,W00005982,W00005982,Output Areas and Small Areas,OASA,210,10,200
288641,W00005983,W00005983,Output Areas and Small Areas,OASA,271,19,252
288642,W00005984,W00005984,Output Areas and Small Areas,OASA,258,15,243
288643,W00005985,W00005985,Output Areas and Small Areas,OASA,271,19,252
288644,W00005986,W00005986,Output Areas and Small Areas,OASA,190,14,176
288645,W00005987,W00005987,Output Areas and Small Areas,OASA,330,43,287
288646,W00005988,W00005988,Output Areas and Small Areas,OASA,330,27,303
288647,W00005990,W00005990,Output Areas and Small Areas,OASA,274,27,247
288648,W00005991,W00005991,Output Areas and Small Areas,OASA,230,24,206
288649,W00005992,W00005992,Output Areas and Small Areas,OASA,337,28,309
288650,W00005994,W00005994,Output Areas and Small Areas,OASA,254,19,235
288651,W00005995,W00005995,Output Areas and Small Areas,OASA,235,22,213
288652,W00005996,W00005996,Output Areas and Small Areas,OASA,275,16,259
288653,W00005997,W00005997,Output Areas and Small Areas,OASA,284,25,259
288654,W00005998,W00005998,Output Areas and Small Areas,OASA,267,21,246
288655,W00005999,W00005999,Output Areas and Small Areas,OASA,231,10,221
288656,W00006000,W00006000,Output Areas and Small Areas,OASA,181,10,171
288657,W00006001,W00006001,Output Areas and Small Areas,OASA,308,18,290
288658,W00006002,W00006002,Output Areas and Small Areas,OASA,134,2,132
288659,W00006003,W00006003,Output Areas and Small Areas,OASA,207,12,195
288660,W00006004,W00006004,Output Areas and Small Areas,OASA,266,12,254
288661,W00006005,W00006005,Output Areas and Small Areas,OASA,195,16,179
288662,W00006006,W00006006,Output Areas and Small Areas,OASA,248,21,227
288663,W00006007,W00006007,Output Areas and Small Areas,OASA,220,17,203
288664,W00006008,W00006008,Output Areas and Small Areas,OASA,241,18,223
288665,W00006009,W00006009,Output Areas and Small Areas,OASA,256,7,249
288666,W00006010,W00006010,Output Areas and Small Areas,OASA,197,9,188
288667,W00006011,W00006011,Output Areas and Small Areas,OASA,223,12,211
288668,W00006012,W00006012,Output Areas and Small Areas,OASA,258,8,250
288669,W00006013,W00006013,Output Areas and Small Areas,OASA,223,11,212
288670,W00006014,W00006014,Output Areas and Small Areas,OASA,253,22,231
288671,W00006015,W00006015,Output Areas and Small Areas,OASA,278,23,255
288672,W00006016,W00006016,Output Areas and Small Areas,OASA,191,15,176
288673,W00006017,W00006017,Output Areas and Small Areas,OASA,210,9,201
288674,W00006018,W00006018,Output Areas and Small Areas,OASA,261,13,248
288675,W00006019,W00006019,Output Areas and Small Areas,OASA,286,16,270
288676,W00006020,W00006020,Output Areas and Small Areas,OASA,268,24,244
288677,W00006021,W00006021,Output Areas and Small Areas,OASA,181,14,167
288678,W00006022,W00006022,Output Areas and Small Areas,OASA,292,21,271
288679,W00006023,W00006023,Output Areas and Small Areas,OASA,222,18,204
288680,W00006024,W00006024,Output Areas and Small Areas,OASA,232,26,206
288681,W00006025,W00006025,Output Areas and Small Areas,OASA,297,12,285
288682,W00006026,W00006026,Output Areas and Small Areas,OASA,248,10,238
288683,W00006027,W00006027,Output Areas and Small Areas,OASA,260,9,251
288684,W00006028,W00006028,Output Areas and Small Areas,OASA,231,15,216
288685,W00006029,W00006029,Output Areas and Small Areas,OASA,248,23,225
288686,W00006030,W00006030,Output Areas and Small Areas,OASA,230,13,217
288687,W00006031,W00006031,Output Areas and Small Areas,OASA,282,17,265
288688,W00006032,W00006032,Output Areas and Small Areas,OASA,343,28,315
288689,W00006033,W00006033,Output Areas and Small Areas,OASA,194,7,187
288690,W00006034,W00006034,Output Areas and Small Areas,OASA,186,9,177
288691,W00006035,W00006035,Output Areas and Small Areas,OASA,245,13,232
288692,W00006036,W00006036,Output Areas and Small Areas,OASA,221,13,208
288693,W00006037,W00006037,Output Areas and Small Areas,OASA,235,8,227
288694,W00006038,W00006038,Output Areas and Small Areas,OASA,247,23,224
288695,W00006039,W00006039,Output Areas and Small Areas,OASA,238,10,228
288696,W00006040,W00006040,Output Areas and Small Areas,OASA,338,21,317
288697,W00006041,W00006041,Output Areas and Small Areas,OASA,234,8,226
288698,W00006042,W00006042,Output Areas and Small Areas,OASA,243,10,233
288699,W00006043,W00006043,Output Areas and Small Areas,OASA,256,5,251
288700,W00006044,W00006044,Output Areas and Small Areas,OASA,239,10,229
288701,W00006045,W00006045,Output Areas and Small Areas,OASA,262,11,251
288702,W00006046,W00006046,Output Areas and Small Areas,OASA,205,16,189
288703,W00006047,W00006047,Output Areas and Small Areas,OASA,200,6,194
288704,W00006048,W00006048,Output Areas and Small Areas,OASA,213,19,194
288705,W00006049,W00006049,Output Areas and Small Areas,OASA,239,24,215
288706,W00006050,W00006050,Output Areas and Small Areas,OASA,200,14,186
288707,W00006051,W00006051,Output Areas and Small Areas,OASA,263,25,238
288708,W00006052,W00006052,Output Areas and Small Areas,OASA,311,30,281
288709,W00006053,W00006053,Output Areas and Small Areas,OASA,231,18,213
288710,W00006054,W00006054,Output Areas and Small Areas,OASA,237,19,218
288711,W00006055,W00006055,Output Areas and Small Areas,OASA,242,14,228
288712,W00006056,W00006056,Output Areas and Small Areas,OASA,211,17,194
288713,W00006057,W00006057,Output Areas and Small Areas,OASA,216,17,199
288714,W00006058,W00006058,Output Areas and Small Areas,OASA,220,21,199
288715,W00006059,W00006059,Output Areas and Small Areas,OASA,190,13,177
288716,W00006060,W00006060,Output Areas and Small Areas,OASA,244,17,227
288717,W00006061,W00006061,Output Areas and Small Areas,OASA,250,27,223
288718,W00006062,W00006062,Output Areas and Small Areas,OASA,268,27,241
288719,W00006063,W00006063,Output Areas and Small Areas,OASA,242,19,223
288720,W00006064,W00006064,Output Areas and Small Areas,OASA,268,27,241
288721,W00006065,W00006065,Output Areas and Small Areas,OASA,242,23,219
288722,W00006066,W00006066,Output Areas and Small Areas,OASA,260,30,230
288723,W00006067,W00006067,Output Areas and Small Areas,OASA,187,21,166
288724,W00006068,W00006068,Output Areas and Small Areas,OASA,173,11,162
288725,W00006069,W00006069,Output Areas and Small Areas,OASA,213,28,185
288726,W00006070,W00006070,Output Areas and Small Areas,OASA,256,36,220
288727,W00006071,W00006071,Output Areas and Small Areas,OASA,216,16,200
288728,W00006072,W00006072,Output Areas and Small Areas,OASA,264,29,235
288729,W00006073,W00006073,Output Areas and Small Areas,OASA,294,31,263
288730,W00006074,W00006074,Output Areas and Small Areas,OASA,232,26,206
288731,W00006075,W00006075,Output Areas and Small Areas,OASA,248,13,235
288732,W00006076,W00006076,Output Areas and Small Areas,OASA,233,21,212
288733,W00006077,W00006077,Output Areas and Small Areas,OASA,212,12,200
288734,W00006078,W00006078,Output Areas and Small Areas,OASA,255,32,223
288735,W00006079,W00006079,Output Areas and Small Areas,OASA,272,25,247
288736,W00006080,W00006080,Output Areas and Small Areas,OASA,308,38,270
288737,W00006081,W00006081,Output Areas and Small Areas,OASA,278,31,247
288738,W00006082,W00006082,Output Areas and Small Areas,OASA,331,31,300
288739,W00006083,W00006083,Output Areas and Small Areas,OASA,218,26,192
288740,W00006084,W00006084,Output Areas and Small Areas,OASA,278,19,259
288741,W00006085,W00006085,Output Areas and Small Areas,OASA,296,17,279
288742,W00006086,W00006086,Output Areas and Small Areas,OASA,200,14,186
288743,W00006087,W00006087,Output Areas and Small Areas,OASA,261,18,243
288744,W00006088,W00006088,Output Areas and Small Areas,OASA,208,16,192
288745,W00006089,W00006089,Output Areas and Small Areas,OASA,216,14,202
288746,W00006090,W00006090,Output Areas and Small Areas,OASA,175,12,163
288747,W00006091,W00006091,Output Areas and Small Areas,OASA,141,10,131
288748,W00006092,W00006092,Output Areas and Small Areas,OASA,246,34,212
288749,W00006093,W00006093,Output Areas and Small Areas,OASA,236,24,212
288750,W00006094,W00006094,Output Areas and Small Areas,OASA,177,13,164
288751,W00006095,W00006095,Output Areas and Small Areas,OASA,316,37,279
288752,W00006096,W00006096,Output Areas and Small Areas,OASA,251,20,231
288753,W00006097,W00006097,Output Areas and Small Areas,OASA,395,40,355
288754,W00006098,W00006098,Output Areas and Small Areas,OASA,244,25,219
288755,W00006099,W00006099,Output Areas and Small Areas,OASA,216,14,202
288756,W00006100,W00006100,Output Areas and Small Areas,OASA,213,24,189
288757,W00006101,W00006101,Output Areas and Small Areas,OASA,222,38,184
288758,W00006102,W00006102,Output Areas and Small Areas,OASA,217,25,192
288759,W00006103,W00006103,Output Areas and Small Areas,OASA,190,24,166
288760,W00006104,W00006104,Output Areas and Small Areas,OASA,293,49,244
288761,W00006105,W00006105,Output Areas and Small Areas,OASA,284,17,267
288762,W00006106,W00006106,Output Areas and Small Areas,OASA,245,15,230
288763,W00006107,W00006107,Output Areas and Small Areas,OASA,254,25,229
288764,W00006108,W00006108,Output Areas and Small Areas,OASA,207,12,195
288765,W00006109,W00006109,Output Areas and Small Areas,OASA,251,25,226
288766,W00006110,W00006110,Output Areas and Small Areas,OASA,206,18,188
288767,W00006111,W00006111,Output Areas and Small Areas,OASA,232,25,207
288768,W00006112,W00006112,Output Areas and Small Areas,OASA,221,18,203
288769,W00006113,W00006113,Output Areas and Small Areas,OASA,230,29,201
288770,W00006114,W00006114,Output Areas and Small Areas,OASA,246,27,219
288771,W00006115,W00006115,Output Areas and Small Areas,OASA,244,37,207
288772,W00006116,W00006116,Output Areas and Small Areas,OASA,237,21,216
288773,W00006117,W00006117,Output Areas and Small Areas,OASA,239,27,212
288774,W00006118,W00006118,Output Areas and Small Areas,OASA,189,9,180
288775,W00006119,W00006119,Output Areas and Small Areas,OASA,216,16,200
288776,W00006120,W00006120,Output Areas and Small Areas,OASA,447,48,399
288777,W00006121,W00006121,Output Areas and Small Areas,OASA,214,21,193
288778,W00006122,W00006122,Output Areas and Small Areas,OASA,336,19,317
288779,W00006123,W00006123,Output Areas and Small Areas,OASA,95,8,87
288780,W00006124,W00006124,Output Areas and Small Areas,OASA,186,15,171
288781,W00006125,W00006125,Output Areas and Small Areas,OASA,278,37,241
288782,W00006126,W00006126,Output Areas and Small Areas,OASA,211,21,190
288783,W00006127,W00006127,Output Areas and Small Areas,OASA,295,16,279
288784,W00006128,W00006128,Output Areas and Small Areas,OASA,352,33,319
288785,W00006129,W00006129,Output Areas and Small Areas,OASA,268,31,237
288786,W00006130,W00006130,Output Areas and Small Areas,OASA,262,22,240
288787,W00006131,W00006131,Output Areas and Small Areas,OASA,179,26,153
288788,W00006133,W00006133,Output Areas and Small Areas,OASA,164,15,149
288789,W00006134,W00006134,Output Areas and Small Areas,OASA,200,19,181
288790,W00006136,W00006136,Output Areas and Small Areas,OASA,324,58,266
288791,W00006137,W00006137,Output Areas and Small Areas,OASA,345,64,281
288792,W00006138,W00006138,Output Areas and Small Areas,OASA,235,24,211
288793,W00006139,W00006139,Output Areas and Small Areas,OASA,213,14,199
288794,W00006140,W00006140,Output Areas and Small Areas,OASA,255,36,219
288795,W00006141,W00006141,Output Areas and Small Areas,OASA,293,33,260
288796,W00006142,W00006142,Output Areas and Small Areas,OASA,220,15,205
288797,W00006143,W00006143,Output Areas and Small Areas,OASA,264,32,232
288798,W00006144,W00006144,Output Areas and Small Areas,OASA,248,23,225
288799,W00006145,W00006145,Output Areas and Small Areas,OASA,295,33,262
288800,W00006146,W00006146,Output Areas and Small Areas,OASA,226,20,206
288801,W00006147,W00006147,Output Areas and Small Areas,OASA,237,24,213
288802,W00006148,W00006148,Output Areas and Small Areas,OASA,236,15,221
288803,W00006149,W00006149,Output Areas and Small Areas,OASA,250,25,225
288804,W00006150,W00006150,Output Areas and Small Areas,OASA,227,10,217
288805,W00006151,W00006151,Output Areas and Small Areas,OASA,225,6,219
288806,W00006152,W00006152,Output Areas and Small Areas,OASA,232,30,202
288807,W00006153,W00006153,Output Areas and Small Areas,OASA,223,13,210
288808,W00006154,W00006154,Output Areas and Small Areas,OASA,210,14,196
288809,W00006155,W00006155,Output Areas and Small Areas,OASA,238,4,234
288810,W00006156,W00006156,Output Areas and Small Areas,OASA,250,11,239
288811,W00006157,W00006157,Output Areas and Small Areas,OASA,179,5,174
288812,W00006158,W00006158,Output Areas and Small Areas,OASA,209,18,191
288813,W00006159,W00006159,Output Areas and Small Areas,OASA,239,7,232
288814,W00006160,W00006160,Output Areas and Small Areas,OASA,244,21,223
288815,W00006161,W00006161,Output Areas and Small Areas,OASA,216,10,206
288816,W00006162,W00006162,Output Areas and Small Areas,OASA,229,17,212
288817,W00006163,W00006163,Output Areas and Small Areas,OASA,251,16,235
288818,W00006164,W00006164,Output Areas and Small Areas,OASA,237,18,219
288819,W00006165,W00006165,Output Areas and Small Areas,OASA,162,15,147
288820,W00006166,W00006166,Output Areas and Small Areas,OASA,245,17,228
288821,W00006167,W00006167,Output Areas and Small Areas,OASA,271,22,249
288822,W00006168,W00006168,Output Areas and Small Areas,OASA,259,28,231
288823,W00006169,W00006169,Output Areas and Small Areas,OASA,262,24,238
288824,W00006170,W00006170,Output Areas and Small Areas,OASA,243,28,215
288825,W00006171,W00006171,Output Areas and Small Areas,OASA,422,34,388
288826,W00006172,W00006172,Output Areas and Small Areas,OASA,204,19,185
288827,W00006173,W00006173,Output Areas and Small Areas,OASA,309,21,288
288828,W00006174,W00006174,Output Areas and Small Areas,OASA,230,8,222
288829,W00006175,W00006175,Output Areas and Small Areas,OASA,196,10,186
288830,W00006176,W00006176,Output Areas and Small Areas,OASA,258,23,235
288831,W00006177,W00006177,Output Areas and Small Areas,OASA,212,7,205
288832,W00006178,W00006178,Output Areas and Small Areas,OASA,178,5,173
288833,W00006179,W00006179,Output Areas and Small Areas,OASA,242,15,227
288834,W00006180,W00006180,Output Areas and Small Areas,OASA,214,17,197
288835,W00006181,W00006181,Output Areas and Small Areas,OASA,257,16,241
288836,W00006182,W00006182,Output Areas and Small Areas,OASA,224,10,214
288837,W00006183,W00006183,Output Areas and Small Areas,OASA,229,13,216
288838,W00006184,W00006184,Output Areas and Small Areas,OASA,202,12,190
288839,W00006185,W00006185,Output Areas and Small Areas,OASA,275,12,263
288840,W00006186,W00006186,Output Areas and Small Areas,OASA,243,36,207
288841,W00006187,W00006187,Output Areas and Small Areas,OASA,238,19,219
288842,W00006188,W00006188,Output Areas and Small Areas,OASA,235,16,219
288843,W00006189,W00006189,Output Areas and Small Areas,OASA,241,20,221
288844,W00006190,W00006190,Output Areas and Small Areas,OASA,223,12,211
288845,W00006191,W00006191,Output Areas and Small Areas,OASA,157,6,151
288846,W00006192,W00006192,Output Areas and Small Areas,OASA,218,14,204
288847,W00006193,W00006193,Output Areas and Small Areas,OASA,208,19,189
288848,W00006194,W00006194,Output Areas and Small Areas,OASA,225,13,212
288849,W00006195,W00006195,Output Areas and Small Areas,OASA,248,39,209
288850,W00006196,W00006196,Output Areas and Small Areas,OASA,231,16,215
288851,W00006197,W00006197,Output Areas and Small Areas,OASA,252,22,230
288852,W00006198,W00006198,Output Areas and Small Areas,OASA,253,25,228
288853,W00006199,W00006199,Output Areas and Small Areas,OASA,230,19,211
288854,W00006200,W00006200,Output Areas and Small Areas,OASA,242,20,222
288855,W00006201,W00006201,Output Areas and Small Areas,OASA,197,16,181
288856,W00006202,W00006202,Output Areas and Small Areas,OASA,162,16,146
288857,W00006203,W00006203,Output Areas and Small Areas,OASA,214,11,203
288858,W00006204,W00006204,Output Areas and Small Areas,OASA,234,21,213
288859,W00006205,W00006205,Output Areas and Small Areas,OASA,180,12,168
288860,W00006206,W00006206,Output Areas and Small Areas,OASA,297,35,262
288861,W00006207,W00006207,Output Areas and Small Areas,OASA,280,23,257
288862,W00006208,W00006208,Output Areas and Small Areas,OASA,191,13,178
288863,W00006209,W00006209,Output Areas and Small Areas,OASA,342,32,310
288864,W00006210,W00006210,Output Areas and Small Areas,OASA,229,15,214
288865,W00006211,W00006211,Output Areas and Small Areas,OASA,291,16,275
288866,W00006212,W00006212,Output Areas and Small Areas,OASA,227,13,214
288867,W00006213,W00006213,Output Areas and Small Areas,OASA,201,9,192
288868,W00006214,W00006214,Output Areas and Small Areas,OASA,299,18,281
288869,W00006215,W00006215,Output Areas and Small Areas,OASA,288,16,272
288870,W00006216,W00006216,Output Areas and Small Areas,OASA,190,13,177
288871,W00006217,W00006217,Output Areas and Small Areas,OASA,206,15,191
288872,W00006218,W00006218,Output Areas and Small Areas,OASA,248,15,233
288873,W00006219,W00006219,Output Areas and Small Areas,OASA,236,11,225
288874,W00006220,W00006220,Output Areas and Small Areas,OASA,233,26,207
288875,W00006221,W00006221,Output Areas and Small Areas,OASA,247,23,224
288876,W00006222,W00006222,Output Areas and Small Areas,OASA,211,20,191
288877,W00006223,W00006223,Output Areas and Small Areas,OASA,231,25,206
288878,W00006224,W00006224,Output Areas and Small Areas,OASA,220,15,205
288879,W00006225,W00006225,Output Areas and Small Areas,OASA,218,17,201
288880,W00006226,W00006226,Output Areas and Small Areas,OASA,254,17,237
288881,W00006227,W00006227,Output Areas and Small Areas,OASA,225,17,208
288882,W00006228,W00006228,Output Areas and Small Areas,OASA,269,33,236
288883,W00006229,W00006229,Output Areas and Small Areas,OASA,182,14,168
288884,W00006230,W00006230,Output Areas and Small Areas,OASA,246,22,224
288885,W00006231,W00006231,Output Areas and Small Areas,OASA,204,8,196
288886,W00006232,W00006232,Output Areas and Small Areas,OASA,237,35,202
288887,W00006233,W00006233,Output Areas and Small Areas,OASA,217,17,200
288888,W00006234,W00006234,Output Areas and Small Areas,OASA,228,20,208
288889,W00006235,W00006235,Output Areas and Small Areas,OASA,206,25,181
288890,W00006236,W00006236,Output Areas and Small Areas,OASA,252,14,238
288891,W00006237,W00006237,Output Areas and Small Areas,OASA,220,15,205
288892,W00006238,W00006238,Output Areas and Small Areas,OASA,215,22,193
288893,W00006239,W00006239,Output Areas and Small Areas,OASA,163,13,150
288894,W00006240,W00006240,Output Areas and Small Areas,OASA,243,20,223
288895,W00006241,W00006241,Output Areas and Small Areas,OASA,253,30,223
288896,W00006242,W00006242,Output Areas and Small Areas,OASA,176,18,158
288897,W00006243,W00006243,Output Areas and Small Areas,OASA,218,17,201
288898,W00006244,W00006244,Output Areas and Small Areas,OASA,244,26,218
288899,W00006245,W00006245,Output Areas and Small Areas,OASA,225,17,208
288900,W00006246,W00006246,Output Areas and Small Areas,OASA,220,9,211
288901,W00006247,W00006247,Output Areas and Small Areas,OASA,191,11,180
288902,W00006248,W00006248,Output Areas and Small Areas,OASA,285,19,266
288903,W00006249,W00006249,Output Areas and Small Areas,OASA,247,12,235
288904,W00006250,W00006250,Output Areas and Small Areas,OASA,319,28,291
288905,W00006251,W00006251,Output Areas and Small Areas,OASA,220,28,192
288906,W00006252,W00006252,Output Areas and Small Areas,OASA,279,31,248
288907,W00006253,W00006253,Output Areas and Small Areas,OASA,250,32,218
288908,W00006254,W00006254,Output Areas and Small Areas,OASA,287,46,241
288909,W00006255,W00006255,Output Areas and Small Areas,OASA,269,29,240
288910,W00006257,W00006257,Output Areas and Small Areas,OASA,324,47,277
288911,W00006259,W00006259,Output Areas and Small Areas,OASA,242,17,225
288912,W00006261,W00006261,Output Areas and Small Areas,OASA,248,37,211
288913,W00006262,W00006262,Output Areas and Small Areas,OASA,178,11,167
288914,W00006263,W00006263,Output Areas and Small Areas,OASA,336,39,297
288915,W00006264,W00006264,Output Areas and Small Areas,OASA,278,40,238
288916,W00006265,W00006265,Output Areas and Small Areas,OASA,293,31,262
288917,W00006266,W00006266,Output Areas and Small Areas,OASA,172,11,161
288918,W00006268,W00006268,Output Areas and Small Areas,OASA,269,40,229
288919,W00006269,W00006269,Output Areas and Small Areas,OASA,334,29,305
288920,W00006270,W00006270,Output Areas and Small Areas,OASA,217,21,196
288921,W00006271,W00006271,Output Areas and Small Areas,OASA,216,18,198
288922,W00006272,W00006272,Output Areas and Small Areas,OASA,273,30,243
288923,W00006273,W00006273,Output Areas and Small Areas,OASA,311,32,279
288924,W00006274,W00006274,Output Areas and Small Areas,OASA,350,37,313
288925,W00006275,W00006275,Output Areas and Small Areas,OASA,245,26,219
288926,W00006276,W00006276,Output Areas and Small Areas,OASA,284,25,259
288927,W00006277,W00006277,Output Areas and Small Areas,OASA,191,18,173
288928,W00006278,W00006278,Output Areas and Small Areas,OASA,211,27,184
288929,W00006279,W00006279,Output Areas and Small Areas,OASA,363,59,304
288930,W00006280,W00006280,Output Areas and Small Areas,OASA,245,14,231
288931,W00006281,W00006281,Output Areas and Small Areas,OASA,241,22,219
288932,W00006282,W00006282,Output Areas and Small Areas,OASA,154,15,139
288933,W00006283,W00006283,Output Areas and Small Areas,OASA,328,22,306
288934,W00006284,W00006284,Output Areas and Small Areas,OASA,368,36,332
288935,W00006286,W00006286,Output Areas and Small Areas,OASA,243,28,215
288936,W00006287,W00006287,Output Areas and Small Areas,OASA,221,29,192
288937,W00006289,W00006289,Output Areas and Small Areas,OASA,215,15,200
288938,W00006290,W00006290,Output Areas and Small Areas,OASA,313,34,279
288939,W00006291,W00006291,Output Areas and Small Areas,OASA,238,31,207
288940,W00006292,W00006292,Output Areas and Small Areas,OASA,226,24,202
288941,W00006293,W00006293,Output Areas and Small Areas,OASA,250,36,214
288942,W00006294,W00006294,Output Areas and Small Areas,OASA,264,40,224
288943,W00006295,W00006295,Output Areas and Small Areas,OASA,262,43,219
288944,W00006296,W00006296,Output Areas and Small Areas,OASA,251,30,221
288945,W00006297,W00006297,Output Areas and Small Areas,OASA,238,33,205
288946,W00006298,W00006298,Output Areas and Small Areas,OASA,269,29,240
288947,W00006299,W00006299,Output Areas and Small Areas,OASA,246,35,211
288948,W00006300,W00006300,Output Areas and Small Areas,OASA,249,17,232
288949,W00006301,W00006301,Output Areas and Small Areas,OASA,248,30,218
288950,W00006302,W00006302,Output Areas and Small Areas,OASA,273,34,239
288951,W00006303,W00006303,Output Areas and Small Areas,OASA,265,44,221
288952,W00006304,W00006304,Output Areas and Small Areas,OASA,295,22,273
288953,W00006305,W00006305,Output Areas and Small Areas,OASA,285,27,258
288954,W00006306,W00006306,Output Areas and Small Areas,OASA,232,26,206
288955,W00006307,W00006307,Output Areas and Small Areas,OASA,240,53,187
288956,W00006308,W00006308,Output Areas and Small Areas,OASA,279,40,239
288957,W00006309,W00006309,Output Areas and Small Areas,OASA,233,25,208
288958,W00006310,W00006310,Output Areas and Small Areas,OASA,248,37,211
288959,W00006311,W00006311,Output Areas and Small Areas,OASA,242,41,201
288960,W00006312,W00006312,Output Areas and Small Areas,OASA,252,39,213
288961,W00006313,W00006313,Output Areas and Small Areas,OASA,187,13,174
288962,W00006314,W00006314,Output Areas and Small Areas,OASA,243,33,210
288963,W00006315,W00006315,Output Areas and Small Areas,OASA,266,40,226
288964,W00006316,W00006316,Output Areas and Small Areas,OASA,395,52,343
288965,W00006317,W00006317,Output Areas and Small Areas,OASA,248,17,231
288966,W00006318,W00006318,Output Areas and Small Areas,OASA,269,32,237
288967,W00006319,W00006319,Output Areas and Small Areas,OASA,266,16,250
288968,W00006320,W00006320,Output Areas and Small Areas,OASA,275,19,256
288969,W00006321,W00006321,Output Areas and Small Areas,OASA,250,16,234
288970,W00006322,W00006322,Output Areas and Small Areas,OASA,260,12,248
288971,W00006323,W00006323,Output Areas and Small Areas,OASA,226,8,218
288972,W00006324,W00006324,Output Areas and Small Areas,OASA,267,19,248
288973,W00006325,W00006325,Output Areas and Small Areas,OASA,294,23,271
288974,W00006326,W00006326,Output Areas and Small Areas,OASA,192,8,184
288975,W00006327,W00006327,Output Areas and Small Areas,OASA,260,6,254
288976,W00006328,W00006328,Output Areas and Small Areas,OASA,201,13,188
288977,W00006329,W00006329,Output Areas and Small Areas,OASA,239,12,227
288978,W00006330,W00006330,Output Areas and Small Areas,OASA,194,17,177
288979,W00006331,W00006331,Output Areas and Small Areas,OASA,198,9,189
288980,W00006332,W00006332,Output Areas and Small Areas,OASA,199,19,180
288981,W00006333,W00006333,Output Areas and Small Areas,OASA,215,18,197
288982,W00006334,W00006334,Output Areas and Small Areas,OASA,201,15,186
288983,W00006335,W00006335,Output Areas and Small Areas,OASA,217,14,203
288984,W00006336,W00006336,Output Areas and Small Areas,OASA,163,13,150
288985,W00006337,W00006337,Output Areas and Small Areas,OASA,274,22,252
288986,W00006338,W00006338,Output Areas and Small Areas,OASA,313,27,286
288987,W00006339,W00006339,Output Areas and Small Areas,OASA,271,18,253
288988,W00006340,W00006340,Output Areas and Small Areas,OASA,290,16,274
288989,W00006341,W00006341,Output Areas and Small Areas,OASA,227,13,214
288990,W00006342,W00006342,Output Areas and Small Areas,OASA,242,13,229
288991,W00006343,W00006343,Output Areas and Small Areas,OASA,227,15,212
288992,W00006344,W00006344,Output Areas and Small Areas,OASA,231,15,216
288993,W00006345,W00006345,Output Areas and Small Areas,OASA,335,21,314
288994,W00006346,W00006346,Output Areas and Small Areas,OASA,243,19,224
288995,W00006347,W00006347,Output Areas and Small Areas,OASA,236,7,229
288996,W00006348,W00006348,Output Areas and Small Areas,OASA,220,18,202
288997,W00006349,W00006349,Output Areas and Small Areas,OASA,259,24,235
288998,W00006350,W00006350,Output Areas and Small Areas,OASA,200,8,192
288999,W00006351,W00006351,Output Areas and Small Areas,OASA,306,17,289
289000,W00006352,W00006352,Output Areas and Small Areas,OASA,221,11,210
289001,W00006353,W00006353,Output Areas and Small Areas,OASA,253,19,234
289002,W00006354,W00006354,Output Areas and Small Areas,OASA,215,9,206
289003,W00006355,W00006355,Output Areas and Small Areas,OASA,286,19,267
289004,W00006356,W00006356,Output Areas and Small Areas,OASA,334,38,296
289005,W00006357,W00006357,Output Areas and Small Areas,OASA,239,8,231
289006,W00006358,W00006358,Output Areas and Small Areas,OASA,206,16,190
289007,W00006359,W00006359,Output Areas and Small Areas,OASA,236,7,229
289008,W00006360,W00006360,Output Areas and Small Areas,OASA,253,18,235
289009,W00006361,W00006361,Output Areas and Small Areas,OASA,169,6,163
289010,W00006362,W00006362,Output Areas and Small Areas,OASA,245,7,238
289011,W00006363,W00006363,Output Areas and Small Areas,OASA,203,16,187
289012,W00006364,W00006364,Output Areas and Small Areas,OASA,253,20,233
289013,W00006365,W00006365,Output Areas and Small Areas,OASA,287,23,264
289014,W00006366,W00006366,Output Areas and Small Areas,OASA,230,12,218
289015,W00006367,W00006367,Output Areas and Small Areas,OASA,220,10,210
289016,W00006368,W00006368,Output Areas and Small Areas,OASA,192,14,178
289017,W00006369,W00006369,Output Areas and Small Areas,OASA,175,11,164
289018,W00006370,W00006370,Output Areas and Small Areas,OASA,230,9,221
289019,W00006371,W00006371,Output Areas and Small Areas,OASA,221,11,210
289020,W00006372,W00006372,Output Areas and Small Areas,OASA,249,13,236
289021,W00006373,W00006373,Output Areas and Small Areas,OASA,234,8,226
289022,W00006374,W00006374,Output Areas and Small Areas,OASA,222,11,211
289023,W00006375,W00006375,Output Areas and Small Areas,OASA,238,4,234
289024,W00006376,W00006376,Output Areas and Small Areas,OASA,163,6,157
289025,W00006377,W00006377,Output Areas and Small Areas,OASA,232,17,215
289026,W00006378,W00006378,Output Areas and Small Areas,OASA,253,17,236
289027,W00006379,W00006379,Output Areas and Small Areas,OASA,242,17,225
289028,W00006380,W00006380,Output Areas and Small Areas,OASA,231,10,221
289029,W00006381,W00006381,Output Areas and Small Areas,OASA,263,7,256
289030,W00006382,W00006382,Output Areas and Small Areas,OASA,211,19,192
289031,W00006383,W00006383,Output Areas and Small Areas,OASA,293,31,262
289032,W00006384,W00006384,Output Areas and Small Areas,OASA,246,24,222
289033,W00006385,W00006385,Output Areas and Small Areas,OASA,207,14,193
289034,W00006386,W00006386,Output Areas and Small Areas,OASA,258,21,237
289035,W00006387,W00006387,Output Areas and Small Areas,OASA,198,19,179
289036,W00006388,W00006388,Output Areas and Small Areas,OASA,193,15,178
289037,W00006389,W00006389,Output Areas and Small Areas,OASA,225,21,204
289038,W00006390,W00006390,Output Areas and Small Areas,OASA,259,21,238
289039,W00006391,W00006391,Output Areas and Small Areas,OASA,258,18,240
289040,W00006392,W00006392,Output Areas and Small Areas,OASA,275,19,256
289041,W00006393,W00006393,Output Areas and Small Areas,OASA,222,19,203
289042,W00006394,W00006394,Output Areas and Small Areas,OASA,244,19,225
289043,W00006395,W00006395,Output Areas and Small Areas,OASA,223,19,204
289044,W00006396,W00006396,Output Areas and Small Areas,OASA,242,33,209
289045,W00006397,W00006397,Output Areas and Small Areas,OASA,220,5,215
289046,W00006398,W00006398,Output Areas and Small Areas,OASA,273,27,246
289047,W00006399,W00006399,Output Areas and Small Areas,OASA,238,18,220
289048,W00006400,W00006400,Output Areas and Small Areas,OASA,247,20,227
289049,W00006401,W00006401,Output Areas and Small Areas,OASA,243,8,235
289050,W00006402,W00006402,Output Areas and Small Areas,OASA,272,13,259
289051,W00006403,W00006403,Output Areas and Small Areas,OASA,195,7,188
289052,W00006404,W00006404,Output Areas and Small Areas,OASA,208,13,195
289053,W00006405,W00006405,Output Areas and Small Areas,OASA,234,20,214
289054,W00006406,W00006406,Output Areas and Small Areas,OASA,270,12,258
289055,W00006407,W00006407,Output Areas and Small Areas,OASA,173,12,161
289056,W00006408,W00006408,Output Areas and Small Areas,OASA,229,15,214
289057,W00006409,W00006409,Output Areas and Small Areas,OASA,238,9,229
289058,W00006410,W00006410,Output Areas and Small Areas,OASA,217,5,212
289059,W00006411,W00006411,Output Areas and Small Areas,OASA,238,16,222
289060,W00006412,W00006412,Output Areas and Small Areas,OASA,259,13,246
289061,W00006413,W00006413,Output Areas and Small Areas,OASA,238,9,229
289062,W00006414,W00006414,Output Areas and Small Areas,OASA,231,14,217
289063,W00006415,W00006415,Output Areas and Small Areas,OASA,268,19,249
289064,W00006416,W00006416,Output Areas and Small Areas,OASA,256,17,239
289065,W00006417,W00006417,Output Areas and Small Areas,OASA,263,25,238
289066,W00006418,W00006418,Output Areas and Small Areas,OASA,210,9,201
289067,W00006419,W00006419,Output Areas and Small Areas,OASA,204,8,196
289068,W00006420,W00006420,Output Areas and Small Areas,OASA,232,18,214
289069,W00006421,W00006421,Output Areas and Small Areas,OASA,292,17,275
289070,W00006422,W00006422,Output Areas and Small Areas,OASA,229,15,214
289071,W00006423,W00006423,Output Areas and Small Areas,OASA,248,19,229
289072,W00006424,W00006424,Output Areas and Small Areas,OASA,210,21,189
289073,W00006425,W00006425,Output Areas and Small Areas,OASA,267,20,247
289074,W00006426,W00006426,Output Areas and Small Areas,OASA,209,14,195
289075,W00006427,W00006427,Output Areas and Small Areas,OASA,207,11,196
289076,W00006428,W00006428,Output Areas and Small Areas,OASA,247,17,230
289077,W00006429,W00006429,Output Areas and Small Areas,OASA,335,41,294
289078,W00006430,W00006430,Output Areas and Small Areas,OASA,325,31,294
289079,W00006431,W00006431,Output Areas and Small Areas,OASA,222,16,206
289080,W00006432,W00006432,Output Areas and Small Areas,OASA,436,52,384
289081,W00006433,W00006433,Output Areas and Small Areas,OASA,243,39,204
289082,W00006434,W00006434,Output Areas and Small Areas,OASA,223,25,198
289083,W00006435,W00006435,Output Areas and Small Areas,OASA,331,53,278
289084,W00006436,W00006436,Output Areas and Small Areas,OASA,343,33,310
289085,W00006437,W00006437,Output Areas and Small Areas,OASA,189,35,154
289086,W00006438,W00006438,Output Areas and Small Areas,OASA,218,15,203
289087,W00006439,W00006439,Output Areas and Small Areas,OASA,418,59,359
289088,W00006440,W00006440,Output Areas and Small Areas,OASA,383,53,330
289089,W00006441,W00006441,Output Areas and Small Areas,OASA,199,14,185
289090,W00006442,W00006442,Output Areas and Small Areas,OASA,268,37,231
289091,W00006443,W00006443,Output Areas and Small Areas,OASA,241,19,222
289092,W00006444,W00006444,Output Areas and Small Areas,OASA,253,17,236
289093,W00006445,W00006445,Output Areas and Small Areas,OASA,428,63,365
289094,W00006446,W00006446,Output Areas and Small Areas,OASA,212,15,197
289095,W00006447,W00006447,Output Areas and Small Areas,OASA,233,21,212
289096,W00006448,W00006448,Output Areas and Small Areas,OASA,307,49,258
289097,W00006449,W00006449,Output Areas and Small Areas,OASA,282,40,242
289098,W00006450,W00006450,Output Areas and Small Areas,OASA,256,34,222
289099,W00006451,W00006451,Output Areas and Small Areas,OASA,212,36,176
289100,W00006452,W00006452,Output Areas and Small Areas,OASA,277,33,244
289101,W00006453,W00006453,Output Areas and Small Areas,OASA,292,53,239
289102,W00006454,W00006454,Output Areas and Small Areas,OASA,262,33,229
289103,W00006455,W00006455,Output Areas and Small Areas,OASA,230,30,200
289104,W00006456,W00006456,Output Areas and Small Areas,OASA,266,43,223
289105,W00006457,W00006457,Output Areas and Small Areas,OASA,248,20,228
289106,W00006458,W00006458,Output Areas and Small Areas,OASA,275,16,259
289107,W00006459,W00006459,Output Areas and Small Areas,OASA,234,23,211
289108,W00006460,W00006460,Output Areas and Small Areas,OASA,255,20,235
289109,W00006461,W00006461,Output Areas and Small Areas,OASA,263,32,231
289110,W00006462,W00006462,Output Areas and Small Areas,OASA,280,24,256
289111,W00006463,W00006463,Output Areas and Small Areas,OASA,222,16,206
289112,W00006464,W00006464,Output Areas and Small Areas,OASA,217,32,185
289113,W00006465,W00006465,Output Areas and Small Areas,OASA,232,23,209
289114,W00006466,W00006466,Output Areas and Small Areas,OASA,253,34,219
289115,W00006467,W00006467,Output Areas and Small Areas,OASA,336,29,307
289116,W00006468,W00006468,Output Areas and Small Areas,OASA,240,24,216
289117,W00006469,W00006469,Output Areas and Small Areas,OASA,256,19,237
289118,W00006470,W00006470,Output Areas and Small Areas,OASA,244,23,221
289119,W00006471,W00006471,Output Areas and Small Areas,OASA,253,18,235
289120,W00006472,W00006472,Output Areas and Small Areas,OASA,278,24,254
289121,W00006473,W00006473,Output Areas and Small Areas,OASA,181,14,167
289122,W00006474,W00006474,Output Areas and Small Areas,OASA,182,13,169
289123,W00006475,W00006475,Output Areas and Small Areas,OASA,215,23,192
289124,W00006476,W00006476,Output Areas and Small Areas,OASA,268,31,237
289125,W00006477,W00006477,Output Areas and Small Areas,OASA,228,32,196
289126,W00006478,W00006478,Output Areas and Small Areas,OASA,207,24,183
289127,W00006479,W00006479,Output Areas and Small Areas,OASA,272,46,226
289128,W00006480,W00006480,Output Areas and Small Areas,OASA,207,32,175
289129,W00006481,W00006481,Output Areas and Small Areas,OASA,144,18,126
289130,W00006482,W00006482,Output Areas and Small Areas,OASA,247,25,222
289131,W00006483,W00006483,Output Areas and Small Areas,OASA,124,3,121
289132,W00006484,W00006484,Output Areas and Small Areas,OASA,248,27,221
289133,W00006485,W00006485,Output Areas and Small Areas,OASA,312,36,276
289134,W00006486,W00006486,Output Areas and Small Areas,OASA,203,35,168
289135,W00006487,W00006487,Output Areas and Small Areas,OASA,258,20,238
289136,W00006488,W00006488,Output Areas and Small Areas,OASA,229,23,206
289137,W00006489,W00006489,Output Areas and Small Areas,OASA,235,25,210
289138,W00006490,W00006490,Output Areas and Small Areas,OASA,219,21,198
289139,W00006491,W00006491,Output Areas and Small Areas,OASA,207,10,197
289140,W00006492,W00006492,Output Areas and Small Areas,OASA,218,9,209
289141,W00006493,W00006493,Output Areas and Small Areas,OASA,216,20,196
289142,W00006494,W00006494,Output Areas and Small Areas,OASA,215,20,195
289143,W00006495,W00006495,Output Areas and Small Areas,OASA,267,25,242
289144,W00006496,W00006496,Output Areas and Small Areas,OASA,261,28,233
289145,W00006497,W00006497,Output Areas and Small Areas,OASA,232,15,217
289146,W00006498,W00006498,Output Areas and Small Areas,OASA,282,32,250
289147,W00006499,W00006499,Output Areas and Small Areas,OASA,204,19,185
289148,W00006500,W00006500,Output Areas and Small Areas,OASA,251,17,234
289149,W00006501,W00006501,Output Areas and Small Areas,OASA,257,25,232
289150,W00006502,W00006502,Output Areas and Small Areas,OASA,224,23,201
289151,W00006503,W00006503,Output Areas and Small Areas,OASA,292,23,269
289152,W00006504,W00006504,Output Areas and Small Areas,OASA,221,7,214
289153,W00006505,W00006505,Output Areas and Small Areas,OASA,185,11,174
289154,W00006506,W00006506,Output Areas and Small Areas,OASA,195,22,173
289155,W00006507,W00006507,Output Areas and Small Areas,OASA,252,26,226
289156,W00006508,W00006508,Output Areas and Small Areas,OASA,229,15,214
289157,W00006509,W00006509,Output Areas and Small Areas,OASA,255,13,242
289158,W00006510,W00006510,Output Areas and Small Areas,OASA,182,13,169
289159,W00006511,W00006511,Output Areas and Small Areas,OASA,264,20,244
289160,W00006512,W00006512,Output Areas and Small Areas,OASA,256,31,225
289161,W00006513,W00006513,Output Areas and Small Areas,OASA,215,14,201
289162,W00006514,W00006514,Output Areas and Small Areas,OASA,230,17,213
289163,W00006515,W00006515,Output Areas and Small Areas,OASA,389,62,327
289164,W00006516,W00006516,Output Areas and Small Areas,OASA,303,29,274
289165,W00006517,W00006517,Output Areas and Small Areas,OASA,247,20,227
289166,W00006518,W00006518,Output Areas and Small Areas,OASA,256,35,221
289167,W00006519,W00006519,Output Areas and Small Areas,OASA,229,25,204
289168,W00006520,W00006520,Output Areas and Small Areas,OASA,210,23,187
289169,W00006521,W00006521,Output Areas and Small Areas,OASA,244,22,222
289170,W00006522,W00006522,Output Areas and Small Areas,OASA,220,20,200
289171,W00006523,W00006523,Output Areas and Small Areas,OASA,231,27,204
289172,W00006524,W00006524,Output Areas and Small Areas,OASA,255,45,210
289173,W00006525,W00006525,Output Areas and Small Areas,OASA,220,33,187
289174,W00006526,W00006526,Output Areas and Small Areas,OASA,271,30,241
289175,W00006527,W00006527,Output Areas and Small Areas,OASA,181,17,164
289176,W00006528,W00006528,Output Areas and Small Areas,OASA,349,44,305
289177,W00006529,W00006529,Output Areas and Small Areas,OASA,218,18,200
289178,W00006530,W00006530,Output Areas and Small Areas,OASA,254,27,227
289179,W00006531,W00006531,Output Areas and Small Areas,OASA,304,26,278
289180,W00006532,W00006532,Output Areas and Small Areas,OASA,265,27,238
289181,W00006533,W00006533,Output Areas and Small Areas,OASA,238,39,199
289182,W00006534,W00006534,Output Areas and Small Areas,OASA,278,25,253
289183,W00006535,W00006535,Output Areas and Small Areas,OASA,203,14,189
289184,W00006536,W00006536,Output Areas and Small Areas,OASA,288,36,252
289185,W00006537,W00006537,Output Areas and Small Areas,OASA,271,19,252
289186,W00006538,W00006538,Output Areas and Small Areas,OASA,274,40,234
289187,W00006539,W00006539,Output Areas and Small Areas,OASA,216,16,200
289188,W00006540,W00006540,Output Areas and Small Areas,OASA,215,17,198
289189,W00006541,W00006541,Output Areas and Small Areas,OASA,227,21,206
289190,W00006542,W00006542,Output Areas and Small Areas,OASA,196,25,171
289191,W00006543,W00006543,Output Areas and Small Areas,OASA,246,20,226
289192,W00006544,W00006544,Output Areas and Small Areas,OASA,252,29,223
289193,W00006545,W00006545,Output Areas and Small Areas,OASA,242,37,205
289194,W00006546,W00006546,Output Areas and Small Areas,OASA,315,35,280
289195,W00006547,W00006547,Output Areas and Small Areas,OASA,256,28,228
289196,W00006548,W00006548,Output Areas and Small Areas,OASA,225,29,196
289197,W00006549,W00006549,Output Areas and Small Areas,OASA,258,34,224
289198,W00006550,W00006550,Output Areas and Small Areas,OASA,232,26,206
289199,W00006551,W00006551,Output Areas and Small Areas,OASA,486,37,449
289200,W00006552,W00006552,Output Areas and Small Areas,OASA,220,7,213
289201,W00006553,W00006553,Output Areas and Small Areas,OASA,274,15,259
289202,W00006554,W00006554,Output Areas and Small Areas,OASA,230,18,212
289203,W00006555,W00006555,Output Areas and Small Areas,OASA,225,10,215
289204,W00006556,W00006556,Output Areas and Small Areas,OASA,248,21,227
289205,W00006557,W00006557,Output Areas and Small Areas,OASA,239,10,229
289206,W00006558,W00006558,Output Areas and Small Areas,OASA,200,9,191
289207,W00006559,W00006559,Output Areas and Small Areas,OASA,264,14,250
289208,W00006560,W00006560,Output Areas and Small Areas,OASA,193,10,183
289209,W00006561,W00006561,Output Areas and Small Areas,OASA,229,17,212
289210,W00006562,W00006562,Output Areas and Small Areas,OASA,234,14,220
289211,W00006563,W00006563,Output Areas and Small Areas,OASA,464,41,423
289212,W00006564,W00006564,Output Areas and Small Areas,OASA,362,37,325
289213,W00006565,W00006565,Output Areas and Small Areas,OASA,277,17,260
289214,W00006566,W00006566,Output Areas and Small Areas,OASA,312,22,290
289215,W00006567,W00006567,Output Areas and Small Areas,OASA,232,17,215
289216,W00006568,W00006568,Output Areas and Small Areas,OASA,157,14,143
289217,W00006569,W00006569,Output Areas and Small Areas,OASA,291,20,271
289218,W00006570,W00006570,Output Areas and Small Areas,OASA,226,20,206
289219,W00006571,W00006571,Output Areas and Small Areas,OASA,185,15,170
289220,W00006572,W00006572,Output Areas and Small Areas,OASA,230,22,208
289221,W00006573,W00006573,Output Areas and Small Areas,OASA,321,29,292
289222,W00006574,W00006574,Output Areas and Small Areas,OASA,247,25,222
289223,W00006575,W00006575,Output Areas and Small Areas,OASA,258,21,237
289224,W00006576,W00006576,Output Areas and Small Areas,OASA,224,14,210
289225,W00006577,W00006577,Output Areas and Small Areas,OASA,274,18,256
289226,W00006578,W00006578,Output Areas and Small Areas,OASA,252,17,235
289227,W00006579,W00006579,Output Areas and Small Areas,OASA,260,28,232
289228,W00006580,W00006580,Output Areas and Small Areas,OASA,230,13,217
289229,W00006581,W00006581,Output Areas and Small Areas,OASA,242,16,226
289230,W00006583,W00006583,Output Areas and Small Areas,OASA,243,14,229
289231,W00006584,W00006584,Output Areas and Small Areas,OASA,288,14,274
289232,W00006585,W00006585,Output Areas and Small Areas,OASA,184,6,178
289233,W00006586,W00006586,Output Areas and Small Areas,OASA,360,27,333
289234,W00006587,W00006587,Output Areas and Small Areas,OASA,245,10,235
289235,W00006588,W00006588,Output Areas and Small Areas,OASA,243,11,232
289236,W00006589,W00006589,Output Areas and Small Areas,OASA,293,11,282
289237,W00006590,W00006590,Output Areas and Small Areas,OASA,246,17,229
289238,W00006591,W00006591,Output Areas and Small Areas,OASA,370,39,331
289239,W00006592,W00006592,Output Areas and Small Areas,OASA,248,16,232
289240,W00006593,W00006593,Output Areas and Small Areas,OASA,191,6,185
289241,W00006594,W00006594,Output Areas and Small Areas,OASA,234,18,216
289242,W00006596,W00006596,Output Areas and Small Areas,OASA,211,25,186
289243,W00006597,W00006597,Output Areas and Small Areas,OASA,228,26,202
289244,W00006598,W00006598,Output Areas and Small Areas,OASA,275,37,238
289245,W00006599,W00006599,Output Areas and Small Areas,OASA,239,36,203
289246,W00006600,W00006600,Output Areas and Small Areas,OASA,258,20,238
289247,W00006601,W00006601,Output Areas and Small Areas,OASA,274,27,247
289248,W00006602,W00006602,Output Areas and Small Areas,OASA,256,35,221
289249,W00006603,W00006603,Output Areas and Small Areas,OASA,215,26,189
289250,W00006604,W00006604,Output Areas and Small Areas,OASA,220,19,201
289251,W00006605,W00006605,Output Areas and Small Areas,OASA,210,23,187
289252,W00006606,W00006606,Output Areas and Small Areas,OASA,302,25,277
289253,W00006607,W00006607,Output Areas and Small Areas,OASA,244,22,222
289254,W00006608,W00006608,Output Areas and Small Areas,OASA,185,19,166
289255,W00006609,W00006609,Output Areas and Small Areas,OASA,275,20,255
289256,W00006610,W00006610,Output Areas and Small Areas,OASA,283,14,269
289257,W00006611,W00006611,Output Areas and Small Areas,OASA,266,23,243
289258,W00006612,W00006612,Output Areas and Small Areas,OASA,222,11,211
289259,W00006613,W00006613,Output Areas and Small Areas,OASA,195,9,186
289260,W00006614,W00006614,Output Areas and Small Areas,OASA,184,13,171
289261,W00006615,W00006615,Output Areas and Small Areas,OASA,267,10,257
289262,W00006616,W00006616,Output Areas and Small Areas,OASA,255,13,242
289263,W00006617,W00006617,Output Areas and Small Areas,OASA,252,19,233
289264,W00006618,W00006618,Output Areas and Small Areas,OASA,301,24,277
289265,W00006619,W00006619,Output Areas and Small Areas,OASA,265,13,252
289266,W00006620,W00006620,Output Areas and Small Areas,OASA,257,14,243
289267,W00006621,W00006621,Output Areas and Small Areas,OASA,256,5,251
289268,W00006622,W00006622,Output Areas and Small Areas,OASA,213,24,189
289269,W00006623,W00006623,Output Areas and Small Areas,OASA,350,36,314
289270,W00006624,W00006624,Output Areas and Small Areas,OASA,303,26,277
289271,W00006625,W00006625,Output Areas and Small Areas,OASA,425,41,384
289272,W00006626,W00006626,Output Areas and Small Areas,OASA,353,22,331
289273,W00006627,W00006627,Output Areas and Small Areas,OASA,265,16,249
289274,W00006628,W00006628,Output Areas and Small Areas,OASA,449,44,405
289275,W00006629,W00006629,Output Areas and Small Areas,OASA,365,28,337
289276,W00006630,W00006630,Output Areas and Small Areas,OASA,335,18,317
289277,W00006631,W00006631,Output Areas and Small Areas,OASA,321,32,289
289278,W00006633,W00006633,Output Areas and Small Areas,OASA,304,21,283
289279,W00006634,W00006634,Output Areas and Small Areas,OASA,239,17,222
289280,W00006635,W00006635,Output Areas and Small Areas,OASA,249,17,232
289281,W00006636,W00006636,Output Areas and Small Areas,OASA,224,18,206
289282,W00006637,W00006637,Output Areas and Small Areas,OASA,197,19,178
289283,W00006638,W00006638,Output Areas and Small Areas,OASA,202,37,165
289284,W00006639,W00006639,Output Areas and Small Areas,OASA,260,40,220
289285,W00006640,W00006640,Output Areas and Small Areas,OASA,294,49,245
289286,W00006641,W00006641,Output Areas and Small Areas,OASA,186,16,170
289287,W00006642,W00006642,Output Areas and Small Areas,OASA,231,32,199
289288,W00006643,W00006643,Output Areas and Small Areas,OASA,262,41,221
289289,W00006644,W00006644,Output Areas and Small Areas,OASA,196,17,179
289290,W00006645,W00006645,Output Areas and Small Areas,OASA,264,32,232
289291,W00006646,W00006646,Output Areas and Small Areas,OASA,213,21,192
289292,W00006647,W00006647,Output Areas and Small Areas,OASA,247,21,226
289293,W00006648,W00006648,Output Areas and Small Areas,OASA,291,40,251
289294,W00006649,W00006649,Output Areas and Small Areas,OASA,246,28,218
289295,W00006650,W00006650,Output Areas and Small Areas,OASA,193,24,169
289296,W00006651,W00006651,Output Areas and Small Areas,OASA,214,20,194
289297,W00006652,W00006652,Output Areas and Small Areas,OASA,216,14,202
289298,W00006653,W00006653,Output Areas and Small Areas,OASA,266,40,226
289299,W00006654,W00006654,Output Areas and Small Areas,OASA,251,27,224
289300,W00006655,W00006655,Output Areas and Small Areas,OASA,255,24,231
289301,W00006656,W00006656,Output Areas and Small Areas,OASA,251,26,225
289302,W00006657,W00006657,Output Areas and Small Areas,OASA,258,27,231
289303,W00006658,W00006658,Output Areas and Small Areas,OASA,213,18,195
289304,W00006659,W00006659,Output Areas and Small Areas,OASA,225,18,207
289305,W00006660,W00006660,Output Areas and Small Areas,OASA,241,11,230
289306,W00006661,W00006661,Output Areas and Small Areas,OASA,262,18,244
289307,W00006662,W00006662,Output Areas and Small Areas,OASA,180,11,169
289308,W00006663,W00006663,Output Areas and Small Areas,OASA,225,25,200
289309,W00006664,W00006664,Output Areas and Small Areas,OASA,144,16,128
289310,W00006665,W00006665,Output Areas and Small Areas,OASA,291,39,252
289311,W00006666,W00006666,Output Areas and Small Areas,OASA,226,17,209
289312,W00006667,W00006667,Output Areas and Small Areas,OASA,266,22,244
289313,W00006668,W00006668,Output Areas and Small Areas,OASA,251,19,232
289314,W00006669,W00006669,Output Areas and Small Areas,OASA,243,27,216
289315,W00006670,W00006670,Output Areas and Small Areas,OASA,231,34,197
289316,W00006671,W00006671,Output Areas and Small Areas,OASA,275,33,242
289317,W00006672,W00006672,Output Areas and Small Areas,OASA,191,20,171
289318,W00006673,W00006673,Output Areas and Small Areas,OASA,254,43,211
289319,W00006674,W00006674,Output Areas and Small Areas,OASA,253,39,214
289320,W00006675,W00006675,Output Areas and Small Areas,OASA,177,20,157
289321,W00006676,W00006676,Output Areas and Small Areas,OASA,265,35,230
289322,W00006677,W00006677,Output Areas and Small Areas,OASA,219,16,203
289323,W00006678,W00006678,Output Areas and Small Areas,OASA,224,28,196
289324,W00006679,W00006679,Output Areas and Small Areas,OASA,164,17,147
289325,W00006680,W00006680,Output Areas and Small Areas,OASA,291,32,259
289326,W00006681,W00006681,Output Areas and Small Areas,OASA,250,20,230
289327,W00006682,W00006682,Output Areas and Small Areas,OASA,236,12,224
289328,W00006683,W00006683,Output Areas and Small Areas,OASA,253,11,242
289329,W00006684,W00006684,Output Areas and Small Areas,OASA,197,13,184
289330,W00006685,W00006685,Output Areas and Small Areas,OASA,191,6,185
289331,W00006686,W00006686,Output Areas and Small Areas,OASA,191,13,178
289332,W00006687,W00006687,Output Areas and Small Areas,OASA,224,10,214
289333,W00006688,W00006688,Output Areas and Small Areas,OASA,274,18,256
289334,W00006689,W00006689,Output Areas and Small Areas,OASA,179,11,168
289335,W00006690,W00006690,Output Areas and Small Areas,OASA,201,12,189
289336,W00006691,W00006691,Output Areas and Small Areas,OASA,234,20,214
289337,W00006692,W00006692,Output Areas and Small Areas,OASA,249,7,242
289338,W00006693,W00006693,Output Areas and Small Areas,OASA,229,14,215
289339,W00006694,W00006694,Output Areas and Small Areas,OASA,216,17,199
289340,W00006695,W00006695,Output Areas and Small Areas,OASA,212,22,190
289341,W00006696,W00006696,Output Areas and Small Areas,OASA,252,14,238
289342,W00006697,W00006697,Output Areas and Small Areas,OASA,247,16,231
289343,W00006698,W00006698,Output Areas and Small Areas,OASA,258,20,238
289344,W00006699,W00006699,Output Areas and Small Areas,OASA,219,13,206
289345,W00006700,W00006700,Output Areas and Small Areas,OASA,240,21,219
289346,W00006701,W00006701,Output Areas and Small Areas,OASA,271,24,247
289347,W00006702,W00006702,Output Areas and Small Areas,OASA,249,12,237
289348,W00006703,W00006703,Output Areas and Small Areas,OASA,216,12,204
289349,W00006704,W00006704,Output Areas and Small Areas,OASA,212,19,193
289350,W00006705,W00006705,Output Areas and Small Areas,OASA,232,26,206
289351,W00006706,W00006706,Output Areas and Small Areas,OASA,218,16,202
289352,W00006707,W00006707,Output Areas and Small Areas,OASA,168,10,158
289353,W00006708,W00006708,Output Areas and Small Areas,OASA,233,28,205
289354,W00006709,W00006709,Output Areas and Small Areas,OASA,238,20,218
289355,W00006710,W00006710,Output Areas and Small Areas,OASA,244,19,225
289356,W00006711,W00006711,Output Areas and Small Areas,OASA,224,21,203
289357,W00006712,W00006712,Output Areas and Small Areas,OASA,194,13,181
289358,W00006713,W00006713,Output Areas and Small Areas,OASA,217,8,209
289359,W00006714,W00006714,Output Areas and Small Areas,OASA,258,19,239
289360,W00006715,W00006715,Output Areas and Small Areas,OASA,244,26,218
289361,W00006716,W00006716,Output Areas and Small Areas,OASA,210,8,202
289362,W00006717,W00006717,Output Areas and Small Areas,OASA,220,27,193
289363,W00006718,W00006718,Output Areas and Small Areas,OASA,218,17,201
289364,W00006719,W00006719,Output Areas and Small Areas,OASA,220,17,203
289365,W00006720,W00006720,Output Areas and Small Areas,OASA,241,10,231
289366,W00006721,W00006721,Output Areas and Small Areas,OASA,275,33,242
289367,W00006722,W00006722,Output Areas and Small Areas,OASA,246,30,216
289368,W00006723,W00006723,Output Areas and Small Areas,OASA,165,10,155
289369,W00006724,W00006724,Output Areas and Small Areas,OASA,208,18,190
289370,W00006725,W00006725,Output Areas and Small Areas,OASA,356,67,289
289371,W00006726,W00006726,Output Areas and Small Areas,OASA,266,35,231
289372,W00006727,W00006727,Output Areas and Small Areas,OASA,254,27,227
289373,W00006728,W00006728,Output Areas and Small Areas,OASA,250,38,212
289374,W00006729,W00006729,Output Areas and Small Areas,OASA,242,21,221
289375,W00006730,W00006730,Output Areas and Small Areas,OASA,242,29,213
289376,W00006731,W00006731,Output Areas and Small Areas,OASA,261,29,232
289377,W00006732,W00006732,Output Areas and Small Areas,OASA,250,26,224
289378,W00006733,W00006733,Output Areas and Small Areas,OASA,273,32,241
289379,W00006734,W00006734,Output Areas and Small Areas,OASA,230,16,214
289380,W00006735,W00006735,Output Areas and Small Areas,OASA,210,23,187
289381,W00006736,W00006736,Output Areas and Small Areas,OASA,192,16,176
289382,W00006737,W00006737,Output Areas and Small Areas,OASA,253,30,223
289383,W00006738,W00006738,Output Areas and Small Areas,OASA,246,17,229
289384,W00006739,W00006739,Output Areas and Small Areas,OASA,274,15,259
289385,W00006740,W00006740,Output Areas and Small Areas,OASA,260,26,234
289386,W00006741,W00006741,Output Areas and Small Areas,OASA,231,13,218
289387,W00006742,W00006742,Output Areas and Small Areas,OASA,267,15,252
289388,W00006743,W00006743,Output Areas and Small Areas,OASA,224,15,209
289389,W00006744,W00006744,Output Areas and Small Areas,OASA,217,21,196
289390,W00006745,W00006745,Output Areas and Small Areas,OASA,250,24,226
289391,W00006746,W00006746,Output Areas and Small Areas,OASA,227,12,215
289392,W00006747,W00006747,Output Areas and Small Areas,OASA,153,16,137
289393,W00006748,W00006748,Output Areas and Small Areas,OASA,348,33,315
289394,W00006749,W00006749,Output Areas and Small Areas,OASA,269,21,248
289395,W00006750,W00006750,Output Areas and Small Areas,OASA,245,11,234
289396,W00006751,W00006751,Output Areas and Small Areas,OASA,243,34,209
289397,W00006752,W00006752,Output Areas and Small Areas,OASA,234,21,213
289398,W00006753,W00006753,Output Areas and Small Areas,OASA,228,23,205
289399,W00006754,W00006754,Output Areas and Small Areas,OASA,275,16,259
289400,W00006755,W00006755,Output Areas and Small Areas,OASA,230,22,208
289401,W00006756,W00006756,Output Areas and Small Areas,OASA,270,24,246
289402,W00006757,W00006757,Output Areas and Small Areas,OASA,225,19,206
289403,W00006758,W00006758,Output Areas and Small Areas,OASA,229,19,210
289404,W00006759,W00006759,Output Areas and Small Areas,OASA,212,21,191
289405,W00006760,W00006760,Output Areas and Small Areas,OASA,301,24,277
289406,W00006761,W00006761,Output Areas and Small Areas,OASA,206,15,191
289407,W00006762,W00006762,Output Areas and Small Areas,OASA,270,11,259
289408,W00006763,W00006763,Output Areas and Small Areas,OASA,247,17,230
289409,W00006764,W00006764,Output Areas and Small Areas,OASA,261,12,249
289410,W00006765,W00006765,Output Areas and Small Areas,OASA,301,30,271
289411,W00006766,W00006766,Output Areas and Small Areas,OASA,188,6,182
289412,W00006767,W00006767,Output Areas and Small Areas,OASA,280,29,251
289413,W00006768,W00006768,Output Areas and Small Areas,OASA,256,25,231
289414,W00006769,W00006769,Output Areas and Small Areas,OASA,235,25,210
289415,W00006770,W00006770,Output Areas and Small Areas,OASA,259,14,245
289416,W00006771,W00006771,Output Areas and Small Areas,OASA,426,32,394
289417,W00006772,W00006772,Output Areas and Small Areas,OASA,240,31,209
289418,W00006773,W00006773,Output Areas and Small Areas,OASA,244,21,223
289419,W00006774,W00006774,Output Areas and Small Areas,OASA,398,32,366
289420,W00006775,W00006775,Output Areas and Small Areas,OASA,291,26,265
289421,W00006776,W00006776,Output Areas and Small Areas,OASA,302,26,276
289422,W00006777,W00006777,Output Areas and Small Areas,OASA,195,8,187
289423,W00006778,W00006778,Output Areas and Small Areas,OASA,433,35,398
289424,W00006779,W00006779,Output Areas and Small Areas,OASA,450,48,402
289425,W00006780,W00006780,Output Areas and Small Areas,OASA,207,12,195
289426,W00006781,W00006781,Output Areas and Small Areas,OASA,230,7,223
289427,W00006782,W00006782,Output Areas and Small Areas,OASA,204,12,192
289428,W00006783,W00006783,Output Areas and Small Areas,OASA,158,13,145
289429,W00006784,W00006784,Output Areas and Small Areas,OASA,222,10,212
289430,W00006785,W00006785,Output Areas and Small Areas,OASA,240,31,209
289431,W00006786,W00006786,Output Areas and Small Areas,OASA,288,33,255
289432,W00006787,W00006787,Output Areas and Small Areas,OASA,225,10,215
289433,W00006788,W00006788,Output Areas and Small Areas,OASA,234,16,218
289434,W00006789,W00006789,Output Areas and Small Areas,OASA,242,11,231
289435,W00006790,W00006790,Output Areas and Small Areas,OASA,245,10,235
289436,W00006791,W00006791,Output Areas and Small Areas,OASA,269,18,251
289437,W00006792,W00006792,Output Areas and Small Areas,OASA,228,20,208
289438,W00006793,W00006793,Output Areas and Small Areas,OASA,217,6,211
289439,W00006794,W00006794,Output Areas and Small Areas,OASA,204,9,195
289440,W00006795,W00006795,Output Areas and Small Areas,OASA,259,15,244
289441,W00006796,W00006796,Output Areas and Small Areas,OASA,232,13,219
289442,W00006797,W00006797,Output Areas and Small Areas,OASA,213,11,202
289443,W00006798,W00006798,Output Areas and Small Areas,OASA,237,16,221
289444,W00006799,W00006799,Output Areas and Small Areas,OASA,323,16,307
289445,W00006800,W00006800,Output Areas and Small Areas,OASA,325,26,299
289446,W00006801,W00006801,Output Areas and Small Areas,OASA,228,16,212
289447,W00006802,W00006802,Output Areas and Small Areas,OASA,276,25,251
289448,W00006803,W00006803,Output Areas and Small Areas,OASA,287,21,266
289449,W00006804,W00006804,Output Areas and Small Areas,OASA,289,16,273
289450,W00006805,W00006805,Output Areas and Small Areas,OASA,151,5,146
289451,W00006806,W00006806,Output Areas and Small Areas,OASA,265,9,256
289452,W00006807,W00006807,Output Areas and Small Areas,OASA,214,11,203
289453,W00006808,W00006808,Output Areas and Small Areas,OASA,290,13,277
289454,W00006809,W00006809,Output Areas and Small Areas,OASA,209,7,202
289455,W00006810,W00006810,Output Areas and Small Areas,OASA,218,5,213
289456,W00006811,W00006811,Output Areas and Small Areas,OASA,260,8,252
289457,W00006812,W00006812,Output Areas and Small Areas,OASA,223,19,204
289458,W00006813,W00006813,Output Areas and Small Areas,OASA,183,7,176
289459,W00006814,W00006814,Output Areas and Small Areas,OASA,239,10,229
289460,W00006815,W00006815,Output Areas and Small Areas,OASA,302,6,296
289461,W00006816,W00006816,Output Areas and Small Areas,OASA,319,9,310
289462,W00006817,W00006817,Output Areas and Small Areas,OASA,120,6,114
289463,W00006818,W00006818,Output Areas and Small Areas,OASA,219,5,214
289464,W00006819,W00006819,Output Areas and Small Areas,OASA,226,7,219
289465,W00006820,W00006820,Output Areas and Small Areas,OASA,266,8,258
289466,W00006821,W00006821,Output Areas and Small Areas,OASA,239,8,231
289467,W00006822,W00006822,Output Areas and Small Areas,OASA,249,9,240
289468,W00006823,W00006823,Output Areas and Small Areas,OASA,258,9,249
289469,W00006824,W00006824,Output Areas and Small Areas,OASA,235,9,226
289470,W00006825,W00006825,Output Areas and Small Areas,OASA,228,9,219
289471,W00006826,W00006826,Output Areas and Small Areas,OASA,265,10,255
289472,W00006827,W00006827,Output Areas and Small Areas,OASA,208,14,194
289473,W00006828,W00006828,Output Areas and Small Areas,OASA,268,29,239
289474,W00006829,W00006829,Output Areas and Small Areas,OASA,292,29,263
289475,W00006830,W00006830,Output Areas and Small Areas,OASA,231,24,207
289476,W00006831,W00006831,Output Areas and Small Areas,OASA,241,9,232
289477,W00006832,W00006832,Output Areas and Small Areas,OASA,236,13,223
289478,W00006833,W00006833,Output Areas and Small Areas,OASA,170,19,151
289479,W00006834,W00006834,Output Areas and Small Areas,OASA,226,6,220
289480,W00006835,W00006835,Output Areas and Small Areas,OASA,153,12,141
289481,W00006836,W00006836,Output Areas and Small Areas,OASA,231,9,222
289482,W00006837,W00006837,Output Areas and Small Areas,OASA,280,8,272
289483,W00006838,W00006838,Output Areas and Small Areas,OASA,269,18,251
289484,W00006839,W00006839,Output Areas and Small Areas,OASA,291,12,279
289485,W00006840,W00006840,Output Areas and Small Areas,OASA,218,11,207
289486,W00006841,W00006841,Output Areas and Small Areas,OASA,209,9,200
289487,W00006842,W00006842,Output Areas and Small Areas,OASA,290,12,278
289488,W00006843,W00006843,Output Areas and Small Areas,OASA,236,10,226
289489,W00006844,W00006844,Output Areas and Small Areas,OASA,299,26,273
289490,W00006845,W00006845,Output Areas and Small Areas,OASA,254,21,233
289491,W00006846,W00006846,Output Areas and Small Areas,OASA,291,24,267
289492,W00006847,W00006847,Output Areas and Small Areas,OASA,245,11,234
289493,W00006848,W00006848,Output Areas and Small Areas,OASA,278,8,270
289494,W00006849,W00006849,Output Areas and Small Areas,OASA,263,22,241
289495,W00006850,W00006850,Output Areas and Small Areas,OASA,171,4,167
289496,W00006851,W00006851,Output Areas and Small Areas,OASA,216,7,209
289497,W00006852,W00006852,Output Areas and Small Areas,OASA,199,13,186
289498,W00006853,W00006853,Output Areas and Small Areas,OASA,262,19,243
289499,W00006854,W00006854,Output Areas and Small Areas,OASA,245,15,230
289500,W00006855,W00006855,Output Areas and Small Areas,OASA,244,7,237
289501,W00006856,W00006856,Output Areas and Small Areas,OASA,260,7,253
289502,W00006857,W00006857,Output Areas and Small Areas,OASA,233,8,225
289503,W00006858,W00006858,Output Areas and Small Areas,OASA,256,8,248
289504,W00006859,W00006859,Output Areas and Small Areas,OASA,283,9,274
289505,W00006860,W00006860,Output Areas and Small Areas,OASA,217,8,209
289506,W00006861,W00006861,Output Areas and Small Areas,OASA,233,12,221
289507,W00006862,W00006862,Output Areas and Small Areas,OASA,256,11,245
289508,W00006863,W00006863,Output Areas and Small Areas,OASA,236,9,227
289509,W00006864,W00006864,Output Areas and Small Areas,OASA,325,20,305
289510,W00006865,W00006865,Output Areas and Small Areas,OASA,243,9,234
289511,W00006866,W00006866,Output Areas and Small Areas,OASA,223,11,212
289512,W00006867,W00006867,Output Areas and Small Areas,OASA,224,14,210
289513,W00006868,W00006868,Output Areas and Small Areas,OASA,281,15,266
289514,W00006869,W00006869,Output Areas and Small Areas,OASA,253,9,244
289515,W00006870,W00006870,Output Areas and Small Areas,OASA,252,12,240
289516,W00006871,W00006871,Output Areas and Small Areas,OASA,223,15,208
289517,W00006872,W00006872,Output Areas and Small Areas,OASA,252,23,229
289518,W00006873,W00006873,Output Areas and Small Areas,OASA,196,11,185
289519,W00006874,W00006874,Output Areas and Small Areas,OASA,216,14,202
289520,W00006875,W00006875,Output Areas and Small Areas,OASA,349,15,334
289521,W00006876,W00006876,Output Areas and Small Areas,OASA,243,10,233
289522,W00006877,W00006877,Output Areas and Small Areas,OASA,227,11,216
289523,W00006878,W00006878,Output Areas and Small Areas,OASA,259,18,241
289524,W00006879,W00006879,Output Areas and Small Areas,OASA,253,15,238
289525,W00006880,W00006880,Output Areas and Small Areas,OASA,268,19,249
289526,W00006881,W00006881,Output Areas and Small Areas,OASA,268,19,249
289527,W00006882,W00006882,Output Areas and Small Areas,OASA,262,17,245
289528,W00006883,W00006883,Output Areas and Small Areas,OASA,212,15,197
289529,W00006884,W00006884,Output Areas and Small Areas,OASA,277,23,254
289530,W00006885,W00006885,Output Areas and Small Areas,OASA,338,26,312
289531,W00006886,W00006886,Output Areas and Small Areas,OASA,243,10,233
289532,W00006887,W00006887,Output Areas and Small Areas,OASA,218,13,205
289533,W00006888,W00006888,Output Areas and Small Areas,OASA,232,9,223
289534,W00006889,W00006889,Output Areas and Small Areas,OASA,374,20,354
289535,W00006890,W00006890,Output Areas and Small Areas,OASA,290,25,265
289536,W00006891,W00006891,Output Areas and Small Areas,OASA,313,26,287
289537,W00006892,W00006892,Output Areas and Small Areas,OASA,248,13,235
289538,W00006893,W00006893,Output Areas and Small Areas,OASA,221,8,213
289539,W00006894,W00006894,Output Areas and Small Areas,OASA,330,31,299
289540,W00006895,W00006895,Output Areas and Small Areas,OASA,263,20,243
289541,W00006896,W00006896,Output Areas and Small Areas,OASA,264,9,255
289542,W00006897,W00006897,Output Areas and Small Areas,OASA,276,19,257
289543,W00006898,W00006898,Output Areas and Small Areas,OASA,191,5,186
289544,W00006899,W00006899,Output Areas and Small Areas,OASA,241,7,234
289545,W00006900,W00006900,Output Areas and Small Areas,OASA,344,17,327
289546,W00006901,W00006901,Output Areas and Small Areas,OASA,232,13,219
289547,W00006902,W00006902,Output Areas and Small Areas,OASA,254,13,241
289548,W00006903,W00006903,Output Areas and Small Areas,OASA,278,22,256
289549,W00006904,W00006904,Output Areas and Small Areas,OASA,225,11,214
289550,W00006905,W00006905,Output Areas and Small Areas,OASA,266,14,252
289551,W00006906,W00006906,Output Areas and Small Areas,OASA,256,8,248
289552,W00006907,W00006907,Output Areas and Small Areas,OASA,251,9,242
289553,W00006909,W00006909,Output Areas and Small Areas,OASA,266,14,252
289554,W00006910,W00006910,Output Areas and Small Areas,OASA,200,14,186
289555,W00006911,W00006911,Output Areas and Small Areas,OASA,238,39,199
289556,W00006912,W00006912,Output Areas and Small Areas,OASA,275,21,254
289557,W00006913,W00006913,Output Areas and Small Areas,OASA,227,25,202
289558,W00006914,W00006914,Output Areas and Small Areas,OASA,218,23,195
289559,W00006915,W00006915,Output Areas and Small Areas,OASA,306,23,283
289560,W00006916,W00006916,Output Areas and Small Areas,OASA,261,21,240
289561,W00006917,W00006917,Output Areas and Small Areas,OASA,341,26,315
289562,W00006918,W00006918,Output Areas and Small Areas,OASA,247,15,232
289563,W00006919,W00006919,Output Areas and Small Areas,OASA,229,17,212
289564,W00006920,W00006920,Output Areas and Small Areas,OASA,266,23,243
289565,W00006921,W00006921,Output Areas and Small Areas,OASA,231,28,203
289566,W00006922,W00006922,Output Areas and Small Areas,OASA,256,25,231
289567,W00006923,W00006923,Output Areas and Small Areas,OASA,222,17,205
289568,W00006924,W00006924,Output Areas and Small Areas,OASA,295,22,273
289569,W00006925,W00006925,Output Areas and Small Areas,OASA,283,31,252
289570,W00006926,W00006926,Output Areas and Small Areas,OASA,206,12,194
289571,W00006927,W00006927,Output Areas and Small Areas,OASA,309,20,289
289572,W00006928,W00006928,Output Areas and Small Areas,OASA,333,38,295
289573,W00006929,W00006929,Output Areas and Small Areas,OASA,264,25,239
289574,W00006930,W00006930,Output Areas and Small Areas,OASA,165,9,156
289575,W00006931,W00006931,Output Areas and Small Areas,OASA,250,34,216
289576,W00006932,W00006932,Output Areas and Small Areas,OASA,236,16,220
289577,W00006933,W00006933,Output Areas and Small Areas,OASA,222,14,208
289578,W00006934,W00006934,Output Areas and Small Areas,OASA,243,16,227
289579,W00006935,W00006935,Output Areas and Small Areas,OASA,207,13,194
289580,W00006936,W00006936,Output Areas and Small Areas,OASA,282,24,258
289581,W00006937,W00006937,Output Areas and Small Areas,OASA,281,12,269
289582,W00006938,W00006938,Output Areas and Small Areas,OASA,204,20,184
289583,W00006940,W00006940,Output Areas and Small Areas,OASA,326,11,315
289584,W00006941,W00006941,Output Areas and Small Areas,OASA,270,12,258
289585,W00006942,W00006942,Output Areas and Small Areas,OASA,245,14,231
289586,W00006943,W00006943,Output Areas and Small Areas,OASA,206,5,201
289587,W00006944,W00006944,Output Areas and Small Areas,OASA,257,23,234
289588,W00006945,W00006945,Output Areas and Small Areas,OASA,217,12,205
289589,W00006946,W00006946,Output Areas and Small Areas,OASA,212,15,197
289590,W00006947,W00006947,Output Areas and Small Areas,OASA,222,14,208
289591,W00006948,W00006948,Output Areas and Small Areas,OASA,251,10,241
289592,W00006949,W00006949,Output Areas and Small Areas,OASA,296,17,279
289593,W00006950,W00006950,Output Areas and Small Areas,OASA,227,11,216
289594,W00006951,W00006951,Output Areas and Small Areas,OASA,293,15,278
289595,W00006952,W00006952,Output Areas and Small Areas,OASA,235,11,224
289596,W00006953,W00006953,Output Areas and Small Areas,OASA,226,10,216
289597,W00006954,W00006954,Output Areas and Small Areas,OASA,248,17,231
289598,W00006955,W00006955,Output Areas and Small Areas,OASA,246,8,238
289599,W00006956,W00006956,Output Areas and Small Areas,OASA,237,7,230
289600,W00006957,W00006957,Output Areas and Small Areas,OASA,243,18,225
289601,W00006958,W00006958,Output Areas and Small Areas,OASA,250,21,229
289602,W00006959,W00006959,Output Areas and Small Areas,OASA,264,18,246
289603,W00006960,W00006960,Output Areas and Small Areas,OASA,249,18,231
289604,W00006961,W00006961,Output Areas and Small Areas,OASA,264,17,247
289605,W00006962,W00006962,Output Areas and Small Areas,OASA,207,14,193
289606,W00006963,W00006963,Output Areas and Small Areas,OASA,262,8,254
289607,W00006964,W00006964,Output Areas and Small Areas,OASA,240,15,225
289608,W00006965,W00006965,Output Areas and Small Areas,OASA,234,5,229
289609,W00006966,W00006966,Output Areas and Small Areas,OASA,228,19,209
289610,W00006968,W00006968,Output Areas and Small Areas,OASA,265,13,252
289611,W00006969,W00006969,Output Areas and Small Areas,OASA,236,7,229
289612,W00006970,W00006970,Output Areas and Small Areas,OASA,257,9,248
289613,W00006971,W00006971,Output Areas and Small Areas,OASA,168,20,148
289614,W00006972,W00006972,Output Areas and Small Areas,OASA,264,27,237
289615,W00006973,W00006973,Output Areas and Small Areas,OASA,281,29,252
289616,W00006974,W00006974,Output Areas and Small Areas,OASA,226,23,203
289617,W00006975,W00006975,Output Areas and Small Areas,OASA,282,45,237
289618,W00006976,W00006976,Output Areas and Small Areas,OASA,293,47,246
289619,W00006977,W00006977,Output Areas and Small Areas,OASA,292,41,251
289620,W00006978,W00006978,Output Areas and Small Areas,OASA,254,22,232
289621,W00006979,W00006979,Output Areas and Small Areas,OASA,200,17,183
289622,W00006980,W00006980,Output Areas and Small Areas,OASA,232,20,212
289623,W00006981,W00006981,Output Areas and Small Areas,OASA,233,19,214
289624,W00006982,W00006982,Output Areas and Small Areas,OASA,216,29,187
289625,W00006983,W00006983,Output Areas and Small Areas,OASA,285,46,239
289626,W00006984,W00006984,Output Areas and Small Areas,OASA,271,35,236
289627,W00006985,W00006985,Output Areas and Small Areas,OASA,214,21,193
289628,W00006986,W00006986,Output Areas and Small Areas,OASA,247,23,224
289629,W00006987,W00006987,Output Areas and Small Areas,OASA,233,16,217
289630,W00006988,W00006988,Output Areas and Small Areas,OASA,283,36,247
289631,W00006989,W00006989,Output Areas and Small Areas,OASA,252,20,232
289632,W00006990,W00006990,Output Areas and Small Areas,OASA,261,31,230
289633,W00006991,W00006991,Output Areas and Small Areas,OASA,278,29,249
289634,W00006992,W00006992,Output Areas and Small Areas,OASA,249,17,232
289635,W00006993,W00006993,Output Areas and Small Areas,OASA,394,31,363
289636,W00006994,W00006994,Output Areas and Small Areas,OASA,332,22,310
289637,W00006995,W00006995,Output Areas and Small Areas,OASA,320,36,284
289638,W00006996,W00006996,Output Areas and Small Areas,OASA,172,7,165
289639,W00006997,W00006997,Output Areas and Small Areas,OASA,242,11,231
289640,W00006998,W00006998,Output Areas and Small Areas,OASA,225,9,216
289641,W00006999,W00006999,Output Areas and Small Areas,OASA,256,15,241
289642,W00007000,W00007000,Output Areas and Small Areas,OASA,245,22,223
289643,W00007001,W00007001,Output Areas and Small Areas,OASA,217,12,205
289644,W00007002,W00007002,Output Areas and Small Areas,OASA,247,9,238
289645,W00007003,W00007003,Output Areas and Small Areas,OASA,254,17,237
289646,W00007004,W00007004,Output Areas and Small Areas,OASA,219,24,195
289647,W00007005,W00007005,Output Areas and Small Areas,OASA,239,13,226
289648,W00007006,W00007006,Output Areas and Small Areas,OASA,220,16,204
289649,W00007007,W00007007,Output Areas and Small Areas,OASA,272,20,252
289650,W00007008,W00007008,Output Areas and Small Areas,OASA,236,14,222
289651,W00007009,W00007009,Output Areas and Small Areas,OASA,233,19,214
289652,W00007010,W00007010,Output Areas and Small Areas,OASA,227,13,214
289653,W00007011,W00007011,Output Areas and Small Areas,OASA,247,19,228
289654,W00007012,W00007012,Output Areas and Small Areas,OASA,230,19,211
289655,W00007013,W00007013,Output Areas and Small Areas,OASA,250,17,233
289656,W00007014,W00007014,Output Areas and Small Areas,OASA,186,12,174
289657,W00007015,W00007015,Output Areas and Small Areas,OASA,305,19,286
289658,W00007016,W00007016,Output Areas and Small Areas,OASA,241,12,229
289659,W00007017,W00007017,Output Areas and Small Areas,OASA,219,10,209
289660,W00007018,W00007018,Output Areas and Small Areas,OASA,228,18,210
289661,W00007019,W00007019,Output Areas and Small Areas,OASA,247,12,235
289662,W00007020,W00007020,Output Areas and Small Areas,OASA,257,14,243
289663,W00007021,W00007021,Output Areas and Small Areas,OASA,312,20,292
289664,W00007022,W00007022,Output Areas and Small Areas,OASA,220,9,211
289665,W00007023,W00007023,Output Areas and Small Areas,OASA,255,13,242
289666,W00007024,W00007024,Output Areas and Small Areas,OASA,352,22,330
289667,W00007025,W00007025,Output Areas and Small Areas,OASA,264,25,239
289668,W00007026,W00007026,Output Areas and Small Areas,OASA,319,31,288
289669,W00007027,W00007027,Output Areas and Small Areas,OASA,249,12,237
289670,W00007028,W00007028,Output Areas and Small Areas,OASA,322,22,300
289671,W00007029,W00007029,Output Areas and Small Areas,OASA,238,8,230
289672,W00007030,W00007030,Output Areas and Small Areas,OASA,249,23,226
289673,W00007031,W00007031,Output Areas and Small Areas,OASA,270,14,256
289674,W00007032,W00007032,Output Areas and Small Areas,OASA,295,11,284
289675,W00007033,W00007033,Output Areas and Small Areas,OASA,239,20,219
289676,W00007034,W00007034,Output Areas and Small Areas,OASA,225,13,212
289677,W00007035,W00007035,Output Areas and Small Areas,OASA,278,24,254
289678,W00007036,W00007036,Output Areas and Small Areas,OASA,259,24,235
289679,W00007037,W00007037,Output Areas and Small Areas,OASA,298,20,278
289680,W00007038,W00007038,Output Areas and Small Areas,OASA,233,13,220
289681,W00007039,W00007039,Output Areas and Small Areas,OASA,257,13,244
289682,W00007040,W00007040,Output Areas and Small Areas,OASA,224,11,213
289683,W00007041,W00007041,Output Areas and Small Areas,OASA,206,14,192
289684,W00007042,W00007042,Output Areas and Small Areas,OASA,218,21,197
289685,W00007043,W00007043,Output Areas and Small Areas,OASA,220,16,204
289686,W00007044,W00007044,Output Areas and Small Areas,OASA,218,16,202
289687,W00007045,W00007045,Output Areas and Small Areas,OASA,242,13,229
289688,W00007046,W00007046,Output Areas and Small Areas,OASA,259,16,243
289689,W00007047,W00007047,Output Areas and Small Areas,OASA,201,14,187
289690,W00007048,W00007048,Output Areas and Small Areas,OASA,252,10,242
289691,W00007049,W00007049,Output Areas and Small Areas,OASA,279,21,258
289692,W00007050,W00007050,Output Areas and Small Areas,OASA,208,23,185
289693,W00007051,W00007051,Output Areas and Small Areas,OASA,209,10,199
289694,W00007052,W00007052,Output Areas and Small Areas,OASA,210,6,204
289695,W00007053,W00007053,Output Areas and Small Areas,OASA,278,18,260
289696,W00007054,W00007054,Output Areas and Small Areas,OASA,219,5,214
289697,W00007055,W00007055,Output Areas and Small Areas,OASA,357,21,336
289698,W00007056,W00007056,Output Areas and Small Areas,OASA,281,17,264
289699,W00007057,W00007057,Output Areas and Small Areas,OASA,272,19,253
289700,W00007058,W00007058,Output Areas and Small Areas,OASA,266,13,253
289701,W00007059,W00007059,Output Areas and Small Areas,OASA,241,6,235
289702,W00007060,W00007060,Output Areas and Small Areas,OASA,347,16,331
289703,W00007061,W00007061,Output Areas and Small Areas,OASA,244,11,233
289704,W00007062,W00007062,Output Areas and Small Areas,OASA,263,11,252
289705,W00007063,W00007063,Output Areas and Small Areas,OASA,239,11,228
289706,W00007064,W00007064,Output Areas and Small Areas,OASA,246,14,232
289707,W00007065,W00007065,Output Areas and Small Areas,OASA,234,7,227
289708,W00007066,W00007066,Output Areas and Small Areas,OASA,232,13,219
289709,W00007067,W00007067,Output Areas and Small Areas,OASA,422,37,385
289710,W00007068,W00007068,Output Areas and Small Areas,OASA,263,29,234
289711,W00007069,W00007069,Output Areas and Small Areas,OASA,279,14,265
289712,W00007070,W00007070,Output Areas and Small Areas,OASA,259,17,242
289713,W00007071,W00007071,Output Areas and Small Areas,OASA,200,17,183
289714,W00007072,W00007072,Output Areas and Small Areas,OASA,253,16,237
289715,W00007073,W00007073,Output Areas and Small Areas,OASA,254,21,233
289716,W00007074,W00007074,Output Areas and Small Areas,OASA,241,16,225
289717,W00007075,W00007075,Output Areas and Small Areas,OASA,285,9,276
289718,W00007076,W00007076,Output Areas and Small Areas,OASA,249,17,232
289719,W00007077,W00007077,Output Areas and Small Areas,OASA,216,11,205
289720,W00007078,W00007078,Output Areas and Small Areas,OASA,219,14,205
289721,W00007079,W00007079,Output Areas and Small Areas,OASA,253,20,233
289722,W00007080,W00007080,Output Areas and Small Areas,OASA,233,10,223
289723,W00007081,W00007081,Output Areas and Small Areas,OASA,242,17,225
289724,W00007082,W00007082,Output Areas and Small Areas,OASA,249,14,235
289725,W00007083,W00007083,Output Areas and Small Areas,OASA,284,18,266
289726,W00007084,W00007084,Output Areas and Small Areas,OASA,232,7,225
289727,W00007085,W00007085,Output Areas and Small Areas,OASA,235,14,221
289728,W00007086,W00007086,Output Areas and Small Areas,OASA,221,14,207
289729,W00007087,W00007087,Output Areas and Small Areas,OASA,226,7,219
289730,W00007088,W00007088,Output Areas and Small Areas,OASA,244,8,236
289731,W00007089,W00007089,Output Areas and Small Areas,OASA,259,16,243
289732,W00007090,W00007090,Output Areas and Small Areas,OASA,209,11,198
289733,W00007091,W00007091,Output Areas and Small Areas,OASA,243,8,235
289734,W00007092,W00007092,Output Areas and Small Areas,OASA,173,2,171
289735,W00007093,W00007093,Output Areas and Small Areas,OASA,269,12,257
289736,W00007094,W00007094,Output Areas and Small Areas,OASA,248,12,236
289737,W00007095,W00007095,Output Areas and Small Areas,OASA,272,17,255
289738,W00007096,W00007096,Output Areas and Small Areas,OASA,237,4,233
289739,W00007097,W00007097,Output Areas and Small Areas,OASA,233,9,224
289740,W00007098,W00007098,Output Areas and Small Areas,OASA,259,11,248
289741,W00007099,W00007099,Output Areas and Small Areas,OASA,157,2,155
289742,W00007100,W00007100,Output Areas and Small Areas,OASA,276,11,265
289743,W00007101,W00007101,Output Areas and Small Areas,OASA,304,15,289
289744,W00007102,W00007102,Output Areas and Small Areas,OASA,251,10,241
289745,W00007103,W00007103,Output Areas and Small Areas,OASA,228,12,216
289746,W00007104,W00007104,Output Areas and Small Areas,OASA,265,11,254
289747,W00007105,W00007105,Output Areas and Small Areas,OASA,246,6,240
289748,W00007106,W00007106,Output Areas and Small Areas,OASA,251,16,235
289749,W00007107,W00007107,Output Areas and Small Areas,OASA,413,24,389
289750,W00007108,W00007108,Output Areas and Small Areas,OASA,244,7,237
289751,W00007109,W00007109,Output Areas and Small Areas,OASA,268,12,256
289752,W00007110,W00007110,Output Areas and Small Areas,OASA,255,13,242
289753,W00007111,W00007111,Output Areas and Small Areas,OASA,273,8,265
289754,W00007112,W00007112,Output Areas and Small Areas,OASA,285,15,270
289755,W00007113,W00007113,Output Areas and Small Areas,OASA,284,20,264
289756,W00007114,W00007114,Output Areas and Small Areas,OASA,259,22,237
289757,W00007115,W00007115,Output Areas and Small Areas,OASA,234,10,224
289758,W00007116,W00007116,Output Areas and Small Areas,OASA,220,11,209
289759,W00007117,W00007117,Output Areas and Small Areas,OASA,259,15,244
289760,W00007118,W00007118,Output Areas and Small Areas,OASA,270,17,253
289761,W00007119,W00007119,Output Areas and Small Areas,OASA,143,10,133
289762,W00007120,W00007120,Output Areas and Small Areas,OASA,247,11,236
289763,W00007121,W00007121,Output Areas and Small Areas,OASA,203,4,199
289764,W00007122,W00007122,Output Areas and Small Areas,OASA,251,11,240
289765,W00007123,W00007123,Output Areas and Small Areas,OASA,269,23,246
289766,W00007124,W00007124,Output Areas and Small Areas,OASA,244,10,234
289767,W00007125,W00007125,Output Areas and Small Areas,OASA,243,13,230
289768,W00007126,W00007126,Output Areas and Small Areas,OASA,241,18,223
289769,W00007127,W00007127,Output Areas and Small Areas,OASA,269,26,243
289770,W00007128,W00007128,Output Areas and Small Areas,OASA,247,20,227
289771,W00007129,W00007129,Output Areas and Small Areas,OASA,284,17,267
289772,W00007130,W00007130,Output Areas and Small Areas,OASA,280,18,262
289773,W00007131,W00007131,Output Areas and Small Areas,OASA,261,27,234
289774,W00007132,W00007132,Output Areas and Small Areas,OASA,264,14,250
289775,W00007133,W00007133,Output Areas and Small Areas,OASA,246,10,236
289776,W00007134,W00007134,Output Areas and Small Areas,OASA,276,11,265
289777,W00007135,W00007135,Output Areas and Small Areas,OASA,223,16,207
289778,W00007136,W00007136,Output Areas and Small Areas,OASA,235,20,215
289779,W00007137,W00007137,Output Areas and Small Areas,OASA,223,8,215
289780,W00007138,W00007138,Output Areas and Small Areas,OASA,271,21,250
289781,W00007139,W00007139,Output Areas and Small Areas,OASA,269,9,260
289782,W00007140,W00007140,Output Areas and Small Areas,OASA,309,18,291
289783,W00007141,W00007141,Output Areas and Small Areas,OASA,279,27,252
289784,W00007142,W00007142,Output Areas and Small Areas,OASA,204,10,194
289785,W00007143,W00007143,Output Areas and Small Areas,OASA,286,35,251
289786,W00007144,W00007144,Output Areas and Small Areas,OASA,230,30,200
289787,W00007145,W00007145,Output Areas and Small Areas,OASA,311,16,295
289788,W00007146,W00007146,Output Areas and Small Areas,OASA,258,12,246
289789,W00007147,W00007147,Output Areas and Small Areas,OASA,344,18,326
289790,W00007148,W00007148,Output Areas and Small Areas,OASA,266,14,252
289791,W00007149,W00007149,Output Areas and Small Areas,OASA,256,13,243
289792,W00007150,W00007150,Output Areas and Small Areas,OASA,311,9,302
289793,W00007151,W00007151,Output Areas and Small Areas,OASA,309,27,282
289794,W00007152,W00007152,Output Areas and Small Areas,OASA,394,34,360
289795,W00007153,W00007153,Output Areas and Small Areas,OASA,214,18,196
289796,W00007154,W00007154,Output Areas and Small Areas,OASA,236,21,215
289797,W00007155,W00007155,Output Areas and Small Areas,OASA,240,25,215
289798,W00007156,W00007156,Output Areas and Small Areas,OASA,194,15,179
289799,W00007157,W00007157,Output Areas and Small Areas,OASA,369,33,336
289800,W00007158,W00007158,Output Areas and Small Areas,OASA,256,26,230
289801,W00007159,W00007159,Output Areas and Small Areas,OASA,298,36,262
289802,W00007160,W00007160,Output Areas and Small Areas,OASA,245,24,221
289803,W00007161,W00007161,Output Areas and Small Areas,OASA,297,18,279
289804,W00007162,W00007162,Output Areas and Small Areas,OASA,233,16,217
289805,W00007163,W00007163,Output Areas and Small Areas,OASA,233,10,223
289806,W00007164,W00007164,Output Areas and Small Areas,OASA,259,22,237
289807,W00007165,W00007165,Output Areas and Small Areas,OASA,272,23,249
289808,W00007166,W00007166,Output Areas and Small Areas,OASA,273,30,243
289809,W00007167,W00007167,Output Areas and Small Areas,OASA,206,13,193
289810,W00007168,W00007168,Output Areas and Small Areas,OASA,353,32,321
289811,W00007169,W00007169,Output Areas and Small Areas,OASA,218,22,196
289812,W00007170,W00007170,Output Areas and Small Areas,OASA,321,24,297
289813,W00007171,W00007171,Output Areas and Small Areas,OASA,237,7,230
289814,W00007172,W00007172,Output Areas and Small Areas,OASA,248,9,239
289815,W00007173,W00007173,Output Areas and Small Areas,OASA,232,15,217
289816,W00007174,W00007174,Output Areas and Small Areas,OASA,251,19,232
289817,W00007175,W00007175,Output Areas and Small Areas,OASA,240,15,225
289818,W00007176,W00007176,Output Areas and Small Areas,OASA,221,18,203
289819,W00007177,W00007177,Output Areas and Small Areas,OASA,272,20,252
289820,W00007178,W00007178,Output Areas and Small Areas,OASA,236,19,217
289821,W00007179,W00007179,Output Areas and Small Areas,OASA,229,22,207
289822,W00007180,W00007180,Output Areas and Small Areas,OASA,216,15,201
289823,W00007181,W00007181,Output Areas and Small Areas,OASA,252,30,222
289824,W00007182,W00007182,Output Areas and Small Areas,OASA,208,14,194
289825,W00007183,W00007183,Output Areas and Small Areas,OASA,223,22,201
289826,W00007184,W00007184,Output Areas and Small Areas,OASA,227,14,213
289827,W00007185,W00007185,Output Areas and Small Areas,OASA,249,24,225
289828,W00007186,W00007186,Output Areas and Small Areas,OASA,245,23,222
289829,W00007187,W00007187,Output Areas and Small Areas,OASA,399,45,354
289830,W00007188,W00007188,Output Areas and Small Areas,OASA,219,13,206
289831,W00007189,W00007189,Output Areas and Small Areas,OASA,369,50,319
289832,W00007190,W00007190,Output Areas and Small Areas,OASA,284,23,261
289833,W00007191,W00007191,Output Areas and Small Areas,OASA,235,15,220
289834,W00007192,W00007192,Output Areas and Small Areas,OASA,273,27,246
289835,W00007193,W00007193,Output Areas and Small Areas,OASA,266,31,235
289836,W00007194,W00007194,Output Areas and Small Areas,OASA,215,15,200
289837,W00007195,W00007195,Output Areas and Small Areas,OASA,210,26,184
289838,W00007196,W00007196,Output Areas and Small Areas,OASA,218,21,197
289839,W00007197,W00007197,Output Areas and Small Areas,OASA,284,14,270
289840,W00007198,W00007198,Output Areas and Small Areas,OASA,214,24,190
289841,W00007199,W00007199,Output Areas and Small Areas,OASA,265,36,229
289842,W00007200,W00007200,Output Areas and Small Areas,OASA,207,14,193
289843,W00007201,W00007201,Output Areas and Small Areas,OASA,206,8,198
289844,W00007202,W00007202,Output Areas and Small Areas,OASA,229,20,209
289845,W00007203,W00007203,Output Areas and Small Areas,OASA,209,18,191
289846,W00007204,W00007204,Output Areas and Small Areas,OASA,215,13,202
289847,W00007205,W00007205,Output Areas and Small Areas,OASA,216,11,205
289848,W00007206,W00007206,Output Areas and Small Areas,OASA,276,14,262
289849,W00007207,W00007207,Output Areas and Small Areas,OASA,212,14,198
289850,W00007208,W00007208,Output Areas and Small Areas,OASA,266,12,254
289851,W00007209,W00007209,Output Areas and Small Areas,OASA,212,10,202
289852,W00007210,W00007210,Output Areas and Small Areas,OASA,219,14,205
289853,W00007211,W00007211,Output Areas and Small Areas,OASA,285,19,266
289854,W00007212,W00007212,Output Areas and Small Areas,OASA,112,9,103
289855,W00007213,W00007213,Output Areas and Small Areas,OASA,292,35,257
289856,W00007214,W00007214,Output Areas and Small Areas,OASA,385,34,351
289857,W00007215,W00007215,Output Areas and Small Areas,OASA,257,32,225
289858,W00007216,W00007216,Output Areas and Small Areas,OASA,244,18,226
289859,W00007217,W00007217,Output Areas and Small Areas,OASA,166,12,154
289860,W00007218,W00007218,Output Areas and Small Areas,OASA,220,13,207
289861,W00007219,W00007219,Output Areas and Small Areas,OASA,246,12,234
289862,W00007220,W00007220,Output Areas and Small Areas,OASA,171,13,158
289863,W00007221,W00007221,Output Areas and Small Areas,OASA,215,18,197
289864,W00007222,W00007222,Output Areas and Small Areas,OASA,204,18,186
289865,W00007223,W00007223,Output Areas and Small Areas,OASA,241,12,229
289866,W00007224,W00007224,Output Areas and Small Areas,OASA,248,15,233
289867,W00007225,W00007225,Output Areas and Small Areas,OASA,260,18,242
289868,W00007226,W00007226,Output Areas and Small Areas,OASA,228,11,217
289869,W00007227,W00007227,Output Areas and Small Areas,OASA,188,24,164
289870,W00007228,W00007228,Output Areas and Small Areas,OASA,240,29,211
289871,W00007229,W00007229,Output Areas and Small Areas,OASA,213,7,206
289872,W00007230,W00007230,Output Areas and Small Areas,OASA,231,11,220
289873,W00007231,W00007231,Output Areas and Small Areas,OASA,444,25,419
289874,W00007232,W00007232,Output Areas and Small Areas,OASA,278,11,267
289875,W00007233,W00007233,Output Areas and Small Areas,OASA,245,9,236
289876,W00007234,W00007234,Output Areas and Small Areas,OASA,213,9,204
289877,W00007235,W00007235,Output Areas and Small Areas,OASA,286,5,281
289878,W00007236,W00007236,Output Areas and Small Areas,OASA,243,6,237
289879,W00007237,W00007237,Output Areas and Small Areas,OASA,263,8,255
289880,W00007238,W00007238,Output Areas and Small Areas,OASA,256,7,249
289881,W00007239,W00007239,Output Areas and Small Areas,OASA,195,4,191
289882,W00007240,W00007240,Output Areas and Small Areas,OASA,279,5,274
289883,W00007241,W00007241,Output Areas and Small Areas,OASA,285,14,271
289884,W00007242,W00007242,Output Areas and Small Areas,OASA,294,11,283
289885,W00007243,W00007243,Output Areas and Small Areas,OASA,248,9,239
289886,W00007244,W00007244,Output Areas and Small Areas,OASA,363,16,347
289887,W00007245,W00007245,Output Areas and Small Areas,OASA,229,10,219
289888,W00007246,W00007246,Output Areas and Small Areas,OASA,204,6,198
289889,W00007247,W00007247,Output Areas and Small Areas,OASA,275,12,263
289890,W00007248,W00007248,Output Areas and Small Areas,OASA,254,11,243
289891,W00007249,W00007249,Output Areas and Small Areas,OASA,321,15,306
289892,W00007250,W00007250,Output Areas and Small Areas,OASA,270,7,263
289893,W00007251,W00007251,Output Areas and Small Areas,OASA,263,9,254
289894,W00007252,W00007252,Output Areas and Small Areas,OASA,268,11,257
289895,W00007253,W00007253,Output Areas and Small Areas,OASA,193,9,184
289896,W00007254,W00007254,Output Areas and Small Areas,OASA,250,7,243
289897,W00007256,W00007256,Output Areas and Small Areas,OASA,243,8,235
289898,W00007257,W00007257,Output Areas and Small Areas,OASA,156,3,153
289899,W00007258,W00007258,Output Areas and Small Areas,OASA,234,9,225
289900,W00007259,W00007259,Output Areas and Small Areas,OASA,296,15,281
289901,W00007261,W00007261,Output Areas and Small Areas,OASA,238,16,222
289902,W00007262,W00007262,Output Areas and Small Areas,OASA,197,8,189
289903,W00007263,W00007263,Output Areas and Small Areas,OASA,198,8,190
289904,W00007264,W00007264,Output Areas and Small Areas,OASA,251,12,239
289905,W00007265,W00007265,Output Areas and Small Areas,OASA,238,11,227
289906,W00007266,W00007266,Output Areas and Small Areas,OASA,309,16,293
289907,W00007267,W00007267,Output Areas and Small Areas,OASA,272,25,247
289908,W00007268,W00007268,Output Areas and Small Areas,OASA,256,15,241
289909,W00007269,W00007269,Output Areas and Small Areas,OASA,299,26,273
289910,W00007270,W00007270,Output Areas and Small Areas,OASA,304,20,284
289911,W00007271,W00007271,Output Areas and Small Areas,OASA,262,13,249
289912,W00007272,W00007272,Output Areas and Small Areas,OASA,317,26,291
289913,W00007273,W00007273,Output Areas and Small Areas,OASA,237,13,224
289914,W00007274,W00007274,Output Areas and Small Areas,OASA,231,24,207
289915,W00007275,W00007275,Output Areas and Small Areas,OASA,285,27,258
289916,W00007276,W00007276,Output Areas and Small Areas,OASA,252,21,231
289917,W00007277,W00007277,Output Areas and Small Areas,OASA,328,18,310
289918,W00007278,W00007278,Output Areas and Small Areas,OASA,252,16,236
289919,W00007279,W00007279,Output Areas and Small Areas,OASA,337,16,321
289920,W00007280,W00007280,Output Areas and Small Areas,OASA,335,16,319
289921,W00007281,W00007281,Output Areas and Small Areas,OASA,265,7,258
289922,W00007282,W00007282,Output Areas and Small Areas,OASA,259,10,249
289923,W00007284,W00007284,Output Areas and Small Areas,OASA,255,14,241
289924,W00007285,W00007285,Output Areas and Small Areas,OASA,241,5,236
289925,W00007286,W00007286,Output Areas and Small Areas,OASA,302,18,284
289926,W00007287,W00007287,Output Areas and Small Areas,OASA,263,8,255
289927,W00007288,W00007288,Output Areas and Small Areas,OASA,256,7,249
289928,W00007289,W00007289,Output Areas and Small Areas,OASA,289,17,272
289929,W00007290,W00007290,Output Areas and Small Areas,OASA,379,13,366
289930,W00007291,W00007291,Output Areas and Small Areas,OASA,259,17,242
289931,W00007292,W00007292,Output Areas and Small Areas,OASA,243,20,223
289932,W00007293,W00007293,Output Areas and Small Areas,OASA,373,30,343
289933,W00007294,W00007294,Output Areas and Small Areas,OASA,255,25,230
289934,W00007295,W00007295,Output Areas and Small Areas,OASA,334,26,308
289935,W00007296,W00007296,Output Areas and Small Areas,OASA,253,31,222
289936,W00007297,W00007297,Output Areas and Small Areas,OASA,289,15,274
289937,W00007298,W00007298,Output Areas and Small Areas,OASA,273,20,253
289938,W00007299,W00007299,Output Areas and Small Areas,OASA,246,26,220
289939,W00007300,W00007300,Output Areas and Small Areas,OASA,312,12,300
289940,W00007301,W00007301,Output Areas and Small Areas,OASA,231,24,207
289941,W00007302,W00007302,Output Areas and Small Areas,OASA,212,10,202
289942,W00007303,W00007303,Output Areas and Small Areas,OASA,286,23,263
289943,W00007304,W00007304,Output Areas and Small Areas,OASA,217,14,203
289944,W00007305,W00007305,Output Areas and Small Areas,OASA,228,15,213
289945,W00007306,W00007306,Output Areas and Small Areas,OASA,284,23,261
289946,W00007307,W00007307,Output Areas and Small Areas,OASA,349,38,311
289947,W00007308,W00007308,Output Areas and Small Areas,OASA,254,23,231
289948,W00007309,W00007309,Output Areas and Small Areas,OASA,276,26,250
289949,W00007310,W00007310,Output Areas and Small Areas,OASA,222,20,202
289950,W00007311,W00007311,Output Areas and Small Areas,OASA,172,9,163
289951,W00007312,W00007312,Output Areas and Small Areas,OASA,186,7,179
289952,W00007313,W00007313,Output Areas and Small Areas,OASA,230,11,219
289953,W00007314,W00007314,Output Areas and Small Areas,OASA,204,13,191
289954,W00007315,W00007315,Output Areas and Small Areas,OASA,215,23,192
289955,W00007316,W00007316,Output Areas and Small Areas,OASA,200,18,182
289956,W00007318,W00007318,Output Areas and Small Areas,OASA,219,22,197
289957,W00007319,W00007319,Output Areas and Small Areas,OASA,237,24,213
289958,W00007320,W00007320,Output Areas and Small Areas,OASA,296,31,265
289959,W00007322,W00007322,Output Areas and Small Areas,OASA,338,39,299
289960,W00007323,W00007323,Output Areas and Small Areas,OASA,239,27,212
289961,W00007324,W00007324,Output Areas and Small Areas,OASA,220,15,205
289962,W00007325,W00007325,Output Areas and Small Areas,OASA,268,28,240
289963,W00007326,W00007326,Output Areas and Small Areas,OASA,228,8,220
289964,W00007327,W00007327,Output Areas and Small Areas,OASA,252,16,236
289965,W00007328,W00007328,Output Areas and Small Areas,OASA,301,18,283
289966,W00007329,W00007329,Output Areas and Small Areas,OASA,242,18,224
289967,W00007330,W00007330,Output Areas and Small Areas,OASA,259,12,247
289968,W00007331,W00007331,Output Areas and Small Areas,OASA,257,20,237
289969,W00007332,W00007332,Output Areas and Small Areas,OASA,259,14,245
289970,W00007333,W00007333,Output Areas and Small Areas,OASA,252,10,242
289971,W00007334,W00007334,Output Areas and Small Areas,OASA,232,11,221
289972,W00007335,W00007335,Output Areas and Small Areas,OASA,342,11,331
289973,W00007336,W00007336,Output Areas and Small Areas,OASA,369,21,348
289974,W00007337,W00007337,Output Areas and Small Areas,OASA,266,7,259
289975,W00007338,W00007338,Output Areas and Small Areas,OASA,244,17,227
289976,W00007339,W00007339,Output Areas and Small Areas,OASA,224,10,214
289977,W00007340,W00007340,Output Areas and Small Areas,OASA,262,12,250
289978,W00007341,W00007341,Output Areas and Small Areas,OASA,192,7,185
289979,W00007342,W00007342,Output Areas and Small Areas,OASA,271,12,259
289980,W00007343,W00007343,Output Areas and Small Areas,OASA,239,9,230
289981,W00007344,W00007344,Output Areas and Small Areas,OASA,265,10,255
289982,W00007345,W00007345,Output Areas and Small Areas,OASA,221,9,212
289983,W00007346,W00007346,Output Areas and Small Areas,OASA,237,14,223
289984,W00007347,W00007347,Output Areas and Small Areas,OASA,347,15,332
289985,W00007348,W00007348,Output Areas and Small Areas,OASA,257,14,243
289986,W00007349,W00007349,Output Areas and Small Areas,OASA,213,16,197
289987,W00007350,W00007350,Output Areas and Small Areas,OASA,221,12,209
289988,W00007351,W00007351,Output Areas and Small Areas,OASA,277,26,251
289989,W00007352,W00007352,Output Areas and Small Areas,OASA,234,8,226
289990,W00007353,W00007353,Output Areas and Small Areas,OASA,173,7,166
289991,W00007354,W00007354,Output Areas and Small Areas,OASA,244,14,230
289992,W00007355,W00007355,Output Areas and Small Areas,OASA,276,11,265
289993,W00007356,W00007356,Output Areas and Small Areas,OASA,327,16,311
289994,W00007357,W00007357,Output Areas and Small Areas,OASA,233,20,213
289995,W00007358,W00007358,Output Areas and Small Areas,OASA,253,13,240
289996,W00007359,W00007359,Output Areas and Small Areas,OASA,272,8,264
289997,W00007360,W00007360,Output Areas and Small Areas,OASA,265,7,258
289998,W00007361,W00007361,Output Areas and Small Areas,OASA,194,9,185
289999,W00007362,W00007362,Output Areas and Small Areas,OASA,247,16,231
290000,W00007363,W00007363,Output Areas and Small Areas,OASA,266,24,242
290001,W00007364,W00007364,Output Areas and Small Areas,OASA,274,10,264
290002,W00007365,W00007365,Output Areas and Small Areas,OASA,232,11,221
290003,W00007366,W00007366,Output Areas and Small Areas,OASA,285,17,268
290004,W00007367,W00007367,Output Areas and Small Areas,OASA,224,12,212
290005,W00007368,W00007368,Output Areas and Small Areas,OASA,244,12,232
290006,W00007369,W00007369,Output Areas and Small Areas,OASA,239,13,226
290007,W00007370,W00007370,Output Areas and Small Areas,OASA,372,19,353
290008,W00007371,W00007371,Output Areas and Small Areas,OASA,220,14,206
290009,W00007372,W00007372,Output Areas and Small Areas,OASA,257,8,249
290010,W00007373,W00007373,Output Areas and Small Areas,OASA,231,11,220
290011,W00007374,W00007374,Output Areas and Small Areas,OASA,212,8,204
290012,W00007375,W00007375,Output Areas and Small Areas,OASA,268,16,252
290013,W00007376,W00007376,Output Areas and Small Areas,OASA,251,14,237
290014,W00007377,W00007377,Output Areas and Small Areas,OASA,193,6,187
290015,W00007378,W00007378,Output Areas and Small Areas,OASA,239,10,229
290016,W00007379,W00007379,Output Areas and Small Areas,OASA,297,20,277
290017,W00007380,W00007380,Output Areas and Small Areas,OASA,245,13,232
290018,W00007381,W00007381,Output Areas and Small Areas,OASA,262,16,246
290019,W00007382,W00007382,Output Areas and Small Areas,OASA,268,7,261
290020,W00007383,W00007383,Output Areas and Small Areas,OASA,245,14,231
290021,W00007384,W00007384,Output Areas and Small Areas,OASA,242,8,234
290022,W00007385,W00007385,Output Areas and Small Areas,OASA,243,12,231
290023,W00007386,W00007386,Output Areas and Small Areas,OASA,182,12,170
290024,W00007387,W00007387,Output Areas and Small Areas,OASA,242,10,232
290025,W00007388,W00007388,Output Areas and Small Areas,OASA,212,8,204
290026,W00007389,W00007389,Output Areas and Small Areas,OASA,226,11,215
290027,W00007390,W00007390,Output Areas and Small Areas,OASA,254,7,247
290028,W00007391,W00007391,Output Areas and Small Areas,OASA,252,16,236
290029,W00007392,W00007392,Output Areas and Small Areas,OASA,267,17,250
290030,W00007393,W00007393,Output Areas and Small Areas,OASA,272,13,259
290031,W00007394,W00007394,Output Areas and Small Areas,OASA,254,12,242
290032,W00007395,W00007395,Output Areas and Small Areas,OASA,286,15,271
290033,W00007396,W00007396,Output Areas and Small Areas,OASA,259,10,249
290034,W00007397,W00007397,Output Areas and Small Areas,OASA,185,6,179
290035,W00007398,W00007398,Output Areas and Small Areas,OASA,245,24,221
290036,W00007399,W00007399,Output Areas and Small Areas,OASA,288,16,272
290037,W00007400,W00007400,Output Areas and Small Areas,OASA,290,40,250
290038,W00007401,W00007401,Output Areas and Small Areas,OASA,307,26,281
290039,W00007402,W00007402,Output Areas and Small Areas,OASA,269,38,231
290040,W00007403,W00007403,Output Areas and Small Areas,OASA,243,16,227
290041,W00007404,W00007404,Output Areas and Small Areas,OASA,284,31,253
290042,W00007405,W00007405,Output Areas and Small Areas,OASA,277,18,259
290043,W00007406,W00007406,Output Areas and Small Areas,OASA,256,11,245
290044,W00007407,W00007407,Output Areas and Small Areas,OASA,237,17,220
290045,W00007408,W00007408,Output Areas and Small Areas,OASA,288,33,255
290046,W00007409,W00007409,Output Areas and Small Areas,OASA,316,18,298
290047,W00007410,W00007410,Output Areas and Small Areas,OASA,236,24,212
290048,W00007411,W00007411,Output Areas and Small Areas,OASA,206,10,196
290049,W00007412,W00007412,Output Areas and Small Areas,OASA,176,12,164
290050,W00007413,W00007413,Output Areas and Small Areas,OASA,360,35,325
290051,W00007414,W00007414,Output Areas and Small Areas,OASA,226,13,213
290052,W00007415,W00007415,Output Areas and Small Areas,OASA,251,23,228
290053,W00007416,W00007416,Output Areas and Small Areas,OASA,213,16,197
290054,W00007417,W00007417,Output Areas and Small Areas,OASA,275,20,255
290055,W00007418,W00007418,Output Areas and Small Areas,OASA,244,21,223
290056,W00007419,W00007419,Output Areas and Small Areas,OASA,259,16,243
290057,W00007420,W00007420,Output Areas and Small Areas,OASA,335,28,307
290058,W00007421,W00007421,Output Areas and Small Areas,OASA,265,25,240
290059,W00007422,W00007422,Output Areas and Small Areas,OASA,242,12,230
290060,W00007423,W00007423,Output Areas and Small Areas,OASA,268,28,240
290061,W00007424,W00007424,Output Areas and Small Areas,OASA,241,20,221
290062,W00007425,W00007425,Output Areas and Small Areas,OASA,357,28,329
290063,W00007426,W00007426,Output Areas and Small Areas,OASA,259,19,240
290064,W00007427,W00007427,Output Areas and Small Areas,OASA,311,36,275
290065,W00007428,W00007428,Output Areas and Small Areas,OASA,295,31,264
290066,W00007429,W00007429,Output Areas and Small Areas,OASA,327,23,304
290067,W00007430,W00007430,Output Areas and Small Areas,OASA,256,17,239
290068,W00007431,W00007431,Output Areas and Small Areas,OASA,204,19,185
290069,W00007432,W00007432,Output Areas and Small Areas,OASA,201,9,192
290070,W00007433,W00007433,Output Areas and Small Areas,OASA,236,8,228
290071,W00007434,W00007434,Output Areas and Small Areas,OASA,218,10,208
290072,W00007435,W00007435,Output Areas and Small Areas,OASA,204,8,196
290073,W00007436,W00007436,Output Areas and Small Areas,OASA,190,5,185
290074,W00007437,W00007437,Output Areas and Small Areas,OASA,180,14,166
290075,W00007438,W00007438,Output Areas and Small Areas,OASA,223,15,208
290076,W00007439,W00007439,Output Areas and Small Areas,OASA,197,18,179
290077,W00007440,W00007440,Output Areas and Small Areas,OASA,209,8,201
290078,W00007441,W00007441,Output Areas and Small Areas,OASA,200,17,183
290079,W00007442,W00007442,Output Areas and Small Areas,OASA,237,12,225
290080,W00007443,W00007443,Output Areas and Small Areas,OASA,173,17,156
290081,W00007444,W00007444,Output Areas and Small Areas,OASA,239,20,219
290082,W00007445,W00007445,Output Areas and Small Areas,OASA,214,17,197
290083,W00007446,W00007446,Output Areas and Small Areas,OASA,268,37,231
290084,W00007447,W00007447,Output Areas and Small Areas,OASA,250,41,209
290085,W00007448,W00007448,Output Areas and Small Areas,OASA,350,30,320
290086,W00007449,W00007449,Output Areas and Small Areas,OASA,380,39,341
290087,W00007450,W00007450,Output Areas and Small Areas,OASA,237,18,219
290088,W00007451,W00007451,Output Areas and Small Areas,OASA,266,24,242
290089,W00007452,W00007452,Output Areas and Small Areas,OASA,222,20,202
290090,W00007453,W00007453,Output Areas and Small Areas,OASA,303,57,246
290091,W00007454,W00007454,Output Areas and Small Areas,OASA,242,34,208
290092,W00007455,W00007455,Output Areas and Small Areas,OASA,273,29,244
290093,W00007456,W00007456,Output Areas and Small Areas,OASA,253,23,230
290094,W00007457,W00007457,Output Areas and Small Areas,OASA,294,29,265
290095,W00007458,W00007458,Output Areas and Small Areas,OASA,235,25,210
290096,W00007459,W00007459,Output Areas and Small Areas,OASA,256,23,233
290097,W00007460,W00007460,Output Areas and Small Areas,OASA,296,20,276
290098,W00007461,W00007461,Output Areas and Small Areas,OASA,251,9,242
290099,W00007462,W00007462,Output Areas and Small Areas,OASA,245,18,227
290100,W00007463,W00007463,Output Areas and Small Areas,OASA,301,25,276
290101,W00007464,W00007464,Output Areas and Small Areas,OASA,284,18,266
290102,W00007465,W00007465,Output Areas and Small Areas,OASA,264,25,239
290103,W00007466,W00007466,Output Areas and Small Areas,OASA,254,26,228
290104,W00007467,W00007467,Output Areas and Small Areas,OASA,155,8,147
290105,W00007468,W00007468,Output Areas and Small Areas,OASA,243,5,238
290106,W00007469,W00007469,Output Areas and Small Areas,OASA,200,10,190
290107,W00007470,W00007470,Output Areas and Small Areas,OASA,234,9,225
290108,W00007471,W00007471,Output Areas and Small Areas,OASA,236,20,216
290109,W00007472,W00007472,Output Areas and Small Areas,OASA,242,23,219
290110,W00007473,W00007473,Output Areas and Small Areas,OASA,250,27,223
290111,W00007474,W00007474,Output Areas and Small Areas,OASA,306,21,285
290112,W00007475,W00007475,Output Areas and Small Areas,OASA,239,7,232
290113,W00007476,W00007476,Output Areas and Small Areas,OASA,233,11,222
290114,W00007477,W00007477,Output Areas and Small Areas,OASA,246,23,223
290115,W00007478,W00007478,Output Areas and Small Areas,OASA,284,10,274
290116,W00007479,W00007479,Output Areas and Small Areas,OASA,291,11,280
290117,W00007480,W00007480,Output Areas and Small Areas,OASA,224,6,218
290118,W00007481,W00007481,Output Areas and Small Areas,OASA,336,14,322
290119,W00007482,W00007482,Output Areas and Small Areas,OASA,208,18,190
290120,W00007483,W00007483,Output Areas and Small Areas,OASA,315,14,301
290121,W00007484,W00007484,Output Areas and Small Areas,OASA,247,9,238
290122,W00007485,W00007485,Output Areas and Small Areas,OASA,265,17,248
290123,W00007486,W00007486,Output Areas and Small Areas,OASA,276,11,265
290124,W00007487,W00007487,Output Areas and Small Areas,OASA,276,14,262
290125,W00007488,W00007488,Output Areas and Small Areas,OASA,412,48,364
290126,W00007489,W00007489,Output Areas and Small Areas,OASA,212,12,200
290127,W00007490,W00007490,Output Areas and Small Areas,OASA,221,18,203
290128,W00007491,W00007491,Output Areas and Small Areas,OASA,255,15,240
290129,W00007492,W00007492,Output Areas and Small Areas,OASA,183,4,179
290130,W00007493,W00007493,Output Areas and Small Areas,OASA,233,26,207
290131,W00007494,W00007494,Output Areas and Small Areas,OASA,252,13,239
290132,W00007495,W00007495,Output Areas and Small Areas,OASA,212,21,191
290133,W00007496,W00007496,Output Areas and Small Areas,OASA,253,32,221
290134,W00007498,W00007498,Output Areas and Small Areas,OASA,219,22,197
290135,W00007499,W00007499,Output Areas and Small Areas,OASA,267,24,243
290136,W00007500,W00007500,Output Areas and Small Areas,OASA,234,17,217
290137,W00007501,W00007501,Output Areas and Small Areas,OASA,256,21,235
290138,W00007502,W00007502,Output Areas and Small Areas,OASA,286,5,281
290139,W00007503,W00007503,Output Areas and Small Areas,OASA,223,3,220
290140,W00007504,W00007504,Output Areas and Small Areas,OASA,234,11,223
290141,W00007505,W00007505,Output Areas and Small Areas,OASA,187,8,179
290142,W00007506,W00007506,Output Areas and Small Areas,OASA,265,6,259
290143,W00007507,W00007507,Output Areas and Small Areas,OASA,265,6,259
290144,W00007508,W00007508,Output Areas and Small Areas,OASA,238,13,225
290145,W00007509,W00007509,Output Areas and Small Areas,OASA,261,6,255
290146,W00007510,W00007510,Output Areas and Small Areas,OASA,255,2,253
290147,W00007511,W00007511,Output Areas and Small Areas,OASA,232,9,223
290148,W00007512,W00007512,Output Areas and Small Areas,OASA,251,6,245
290149,W00007513,W00007513,Output Areas and Small Areas,OASA,232,4,228
290150,W00007514,W00007514,Output Areas and Small Areas,OASA,264,10,254
290151,W00007515,W00007515,Output Areas and Small Areas,OASA,216,8,208
290152,W00007516,W00007516,Output Areas and Small Areas,OASA,231,7,224
290153,W00007517,W00007517,Output Areas and Small Areas,OASA,211,6,205
290154,W00007518,W00007518,Output Areas and Small Areas,OASA,266,10,256
290155,W00007519,W00007519,Output Areas and Small Areas,OASA,325,14,311
290156,W00007520,W00007520,Output Areas and Small Areas,OASA,191,9,182
290157,W00007521,W00007521,Output Areas and Small Areas,OASA,357,15,342
290158,W00007522,W00007522,Output Areas and Small Areas,OASA,245,11,234
290159,W00007523,W00007523,Output Areas and Small Areas,OASA,246,11,235
290160,W00007524,W00007524,Output Areas and Small Areas,OASA,272,15,257
290161,W00007525,W00007525,Output Areas and Small Areas,OASA,283,17,266
290162,W00007526,W00007526,Output Areas and Small Areas,OASA,257,12,245
290163,W00007527,W00007527,Output Areas and Small Areas,OASA,267,23,244
290164,W00007528,W00007528,Output Areas and Small Areas,OASA,225,6,219
290165,W00007529,W00007529,Output Areas and Small Areas,OASA,276,9,267
290166,W00007530,W00007530,Output Areas and Small Areas,OASA,275,15,260
290167,W00007531,W00007531,Output Areas and Small Areas,OASA,180,8,172
290168,W00007532,W00007532,Output Areas and Small Areas,OASA,228,6,222
290169,W00007533,W00007533,Output Areas and Small Areas,OASA,231,9,222
290170,W00007534,W00007534,Output Areas and Small Areas,OASA,295,11,284
290171,W00007535,W00007535,Output Areas and Small Areas,OASA,247,8,239
290172,W00007536,W00007536,Output Areas and Small Areas,OASA,263,11,252
290173,W00007537,W00007537,Output Areas and Small Areas,OASA,197,7,190
290174,W00007538,W00007538,Output Areas and Small Areas,OASA,248,11,237
290175,W00007539,W00007539,Output Areas and Small Areas,OASA,224,2,222
290176,W00007540,W00007540,Output Areas and Small Areas,OASA,239,7,232
290177,W00007541,W00007541,Output Areas and Small Areas,OASA,214,10,204
290178,W00007542,W00007542,Output Areas and Small Areas,OASA,233,11,222
290179,W00007543,W00007543,Output Areas and Small Areas,OASA,213,7,206
290180,W00007544,W00007544,Output Areas and Small Areas,OASA,203,3,200
290181,W00007545,W00007545,Output Areas and Small Areas,OASA,133,3,130
290182,W00007546,W00007546,Output Areas and Small Areas,OASA,228,12,216
290183,W00007547,W00007547,Output Areas and Small Areas,OASA,411,31,380
290184,W00007548,W00007548,Output Areas and Small Areas,OASA,276,4,272
290185,W00007549,W00007549,Output Areas and Small Areas,OASA,237,6,231
290186,W00007550,W00007550,Output Areas and Small Areas,OASA,264,10,254
290187,W00007551,W00007551,Output Areas and Small Areas,OASA,263,15,248
290188,W00007552,W00007552,Output Areas and Small Areas,OASA,239,8,231
290189,W00007553,W00007553,Output Areas and Small Areas,OASA,219,10,209
290190,W00007554,W00007554,Output Areas and Small Areas,OASA,255,7,248
290191,W00007555,W00007555,Output Areas and Small Areas,OASA,299,10,289
290192,W00007556,W00007556,Output Areas and Small Areas,OASA,277,19,258
290193,W00007557,W00007557,Output Areas and Small Areas,OASA,185,7,178
290194,W00007558,W00007558,Output Areas and Small Areas,OASA,215,9,206
290195,W00007559,W00007559,Output Areas and Small Areas,OASA,231,11,220
290196,W00007560,W00007560,Output Areas and Small Areas,OASA,181,9,172
290197,W00007561,W00007561,Output Areas and Small Areas,OASA,230,7,223
290198,W00007562,W00007562,Output Areas and Small Areas,OASA,200,10,190
290199,W00007563,W00007563,Output Areas and Small Areas,OASA,227,9,218
290200,W00007564,W00007564,Output Areas and Small Areas,OASA,257,17,240
290201,W00007565,W00007565,Output Areas and Small Areas,OASA,248,7,241
290202,W00007566,W00007566,Output Areas and Small Areas,OASA,183,4,179
290203,W00007567,W00007567,Output Areas and Small Areas,OASA,242,10,232
290204,W00007568,W00007568,Output Areas and Small Areas,OASA,279,11,268
290205,W00007569,W00007569,Output Areas and Small Areas,OASA,141,2,139
290206,W00007570,W00007570,Output Areas and Small Areas,OASA,232,12,220
290207,W00007571,W00007571,Output Areas and Small Areas,OASA,254,12,242
290208,W00007572,W00007572,Output Areas and Small Areas,OASA,229,7,222
290209,W00007573,W00007573,Output Areas and Small Areas,OASA,302,10,292
290210,W00007574,W00007574,Output Areas and Small Areas,OASA,252,15,237
290211,W00007575,W00007575,Output Areas and Small Areas,OASA,209,9,200
290212,W00007576,W00007576,Output Areas and Small Areas,OASA,245,10,235
290213,W00007577,W00007577,Output Areas and Small Areas,OASA,257,9,248
290214,W00007578,W00007578,Output Areas and Small Areas,OASA,241,12,229
290215,W00007579,W00007579,Output Areas and Small Areas,OASA,217,4,213
290216,W00007580,W00007580,Output Areas and Small Areas,OASA,231,11,220
290217,W00007581,W00007581,Output Areas and Small Areas,OASA,244,11,233
290218,W00007582,W00007582,Output Areas and Small Areas,OASA,224,8,216
290219,W00007583,W00007583,Output Areas and Small Areas,OASA,248,17,231
290220,W00007584,W00007584,Output Areas and Small Areas,OASA,279,11,268
290221,W00007585,W00007585,Output Areas and Small Areas,OASA,271,13,258
290222,W00007586,W00007586,Output Areas and Small Areas,OASA,224,10,214
290223,W00007587,W00007587,Output Areas and Small Areas,OASA,300,5,295
290224,W00007588,W00007588,Output Areas and Small Areas,OASA,282,12,270
290225,W00007589,W00007589,Output Areas and Small Areas,OASA,257,5,252
290226,W00007590,W00007590,Output Areas and Small Areas,OASA,298,10,288
290227,W00007591,W00007591,Output Areas and Small Areas,OASA,213,10,203
290228,W00007592,W00007592,Output Areas and Small Areas,OASA,205,6,199
290229,W00007593,W00007593,Output Areas and Small Areas,OASA,257,12,245
290230,W00007594,W00007594,Output Areas and Small Areas,OASA,290,12,278
290231,W00007595,W00007595,Output Areas and Small Areas,OASA,273,14,259
290232,W00007596,W00007596,Output Areas and Small Areas,OASA,277,13,264
290233,W00007597,W00007597,Output Areas and Small Areas,OASA,200,1,199
290234,W00007598,W00007598,Output Areas and Small Areas,OASA,274,11,263
290235,W00007599,W00007599,Output Areas and Small Areas,OASA,217,6,211
290236,W00007600,W00007600,Output Areas and Small Areas,OASA,237,5,232
290237,W00007601,W00007601,Output Areas and Small Areas,OASA,223,5,218
290238,W00007602,W00007602,Output Areas and Small Areas,OASA,209,6,203
290239,W00007603,W00007603,Output Areas and Small Areas,OASA,232,2,230
290240,W00007604,W00007604,Output Areas and Small Areas,OASA,215,5,210
290241,W00007605,W00007605,Output Areas and Small Areas,OASA,230,12,218
290242,W00007606,W00007606,Output Areas and Small Areas,OASA,229,6,223
290243,W00007607,W00007607,Output Areas and Small Areas,OASA,303,9,294
290244,W00007608,W00007608,Output Areas and Small Areas,OASA,265,12,253
290245,W00007609,W00007609,Output Areas and Small Areas,OASA,229,11,218
290246,W00007610,W00007610,Output Areas and Small Areas,OASA,219,0,219
290247,W00007611,W00007611,Output Areas and Small Areas,OASA,248,5,243
290248,W00007612,W00007612,Output Areas and Small Areas,OASA,239,8,231
290249,W00007613,W00007613,Output Areas and Small Areas,OASA,251,9,242
290250,W00007614,W00007614,Output Areas and Small Areas,OASA,235,5,230
290251,W00007615,W00007615,Output Areas and Small Areas,OASA,255,8,247
290252,W00007616,W00007616,Output Areas and Small Areas,OASA,197,7,190
290253,W00007617,W00007617,Output Areas and Small Areas,OASA,130,3,127
290254,W00007618,W00007618,Output Areas and Small Areas,OASA,250,9,241
290255,W00007619,W00007619,Output Areas and Small Areas,OASA,253,7,246
290256,W00007620,W00007620,Output Areas and Small Areas,OASA,176,1,175
290257,W00007621,W00007621,Output Areas and Small Areas,OASA,251,9,242
290258,W00007622,W00007622,Output Areas and Small Areas,OASA,261,4,257
290259,W00007623,W00007623,Output Areas and Small Areas,OASA,387,20,367
290260,W00007624,W00007624,Output Areas and Small Areas,OASA,155,1,154
290261,W00007625,W00007625,Output Areas and Small Areas,OASA,266,8,258
290262,W00007626,W00007626,Output Areas and Small Areas,OASA,271,6,265
290263,W00007627,W00007627,Output Areas and Small Areas,OASA,220,6,214
290264,W00007628,W00007628,Output Areas and Small Areas,OASA,219,8,211
290265,W00007629,W00007629,Output Areas and Small Areas,OASA,262,13,249
290266,W00007630,W00007630,Output Areas and Small Areas,OASA,219,7,212
290267,W00007631,W00007631,Output Areas and Small Areas,OASA,250,16,234
290268,W00007632,W00007632,Output Areas and Small Areas,OASA,198,10,188
290269,W00007633,W00007633,Output Areas and Small Areas,OASA,269,6,263
290270,W00007634,W00007634,Output Areas and Small Areas,OASA,385,31,354
290271,W00007635,W00007635,Output Areas and Small Areas,OASA,107,3,104
290272,W00007636,W00007636,Output Areas and Small Areas,OASA,269,9,260
290273,W00007637,W00007637,Output Areas and Small Areas,OASA,186,2,184
290274,W00007638,W00007638,Output Areas and Small Areas,OASA,228,15,213
290275,W00007639,W00007639,Output Areas and Small Areas,OASA,199,5,194
290276,W00007640,W00007640,Output Areas and Small Areas,OASA,281,12,269
290277,W00007641,W00007641,Output Areas and Small Areas,OASA,266,19,247
290278,W00007642,W00007642,Output Areas and Small Areas,OASA,263,15,248
290279,W00007643,W00007643,Output Areas and Small Areas,OASA,210,6,204
290280,W00007644,W00007644,Output Areas and Small Areas,OASA,211,16,195
290281,W00007645,W00007645,Output Areas and Small Areas,OASA,214,4,210
290282,W00007646,W00007646,Output Areas and Small Areas,OASA,229,14,215
290283,W00007647,W00007647,Output Areas and Small Areas,OASA,248,10,238
290284,W00007648,W00007648,Output Areas and Small Areas,OASA,216,7,209
290285,W00007649,W00007649,Output Areas and Small Areas,OASA,283,5,278
290286,W00007650,W00007650,Output Areas and Small Areas,OASA,229,11,218
290287,W00007651,W00007651,Output Areas and Small Areas,OASA,226,3,223
290288,W00007652,W00007652,Output Areas and Small Areas,OASA,230,9,221
290289,W00007653,W00007653,Output Areas and Small Areas,OASA,330,12,318
290290,W00007654,W00007654,Output Areas and Small Areas,OASA,216,6,210
290291,W00007655,W00007655,Output Areas and Small Areas,OASA,258,8,250
290292,W00007656,W00007656,Output Areas and Small Areas,OASA,217,6,211
290293,W00007657,W00007657,Output Areas and Small Areas,OASA,211,6,205
290294,W00007658,W00007658,Output Areas and Small Areas,OASA,223,8,215
290295,W00007659,W00007659,Output Areas and Small Areas,OASA,208,5,203
290296,W00007660,W00007660,Output Areas and Small Areas,OASA,225,9,216
290297,W00007661,W00007661,Output Areas and Small Areas,OASA,280,19,261
290298,W00007662,W00007662,Output Areas and Small Areas,OASA,221,9,212
290299,W00007663,W00007663,Output Areas and Small Areas,OASA,207,8,199
290300,W00007664,W00007664,Output Areas and Small Areas,OASA,211,2,209
290301,W00007665,W00007665,Output Areas and Small Areas,OASA,270,8,262
290302,W00007666,W00007666,Output Areas and Small Areas,OASA,274,14,260
290303,W00007667,W00007667,Output Areas and Small Areas,OASA,270,4,266
290304,W00007668,W00007668,Output Areas and Small Areas,OASA,286,12,274
290305,W00007669,W00007669,Output Areas and Small Areas,OASA,218,10,208
290306,W00007670,W00007670,Output Areas and Small Areas,OASA,238,9,229
290307,W00007672,W00007672,Output Areas and Small Areas,OASA,162,3,159
290308,W00007673,W00007673,Output Areas and Small Areas,OASA,242,9,233
290309,W00007674,W00007674,Output Areas and Small Areas,OASA,234,10,224
290310,W00007675,W00007675,Output Areas and Small Areas,OASA,225,5,220
290311,W00007676,W00007676,Output Areas and Small Areas,OASA,228,6,222
290312,W00007677,W00007677,Output Areas and Small Areas,OASA,211,6,205
290313,W00007678,W00007678,Output Areas and Small Areas,OASA,235,7,228
290314,W00007679,W00007679,Output Areas and Small Areas,OASA,250,5,245
290315,W00007680,W00007680,Output Areas and Small Areas,OASA,260,16,244
290316,W00007681,W00007681,Output Areas and Small Areas,OASA,262,16,246
290317,W00007682,W00007682,Output Areas and Small Areas,OASA,272,6,266
290318,W00007683,W00007683,Output Areas and Small Areas,OASA,228,6,222
290319,W00007684,W00007684,Output Areas and Small Areas,OASA,226,5,221
290320,W00007685,W00007685,Output Areas and Small Areas,OASA,226,9,217
290321,W00007686,W00007686,Output Areas and Small Areas,OASA,256,18,238
290322,W00007687,W00007687,Output Areas and Small Areas,OASA,223,6,217
290323,W00007688,W00007688,Output Areas and Small Areas,OASA,235,4,231
290324,W00007689,W00007689,Output Areas and Small Areas,OASA,200,9,191
290325,W00007690,W00007690,Output Areas and Small Areas,OASA,332,34,298
290326,W00007691,W00007691,Output Areas and Small Areas,OASA,94,4,90
290327,W00007692,W00007692,Output Areas and Small Areas,OASA,257,11,246
290328,W00007693,W00007693,Output Areas and Small Areas,OASA,329,19,310
290329,W00007694,W00007694,Output Areas and Small Areas,OASA,232,9,223
290330,W00007695,W00007695,Output Areas and Small Areas,OASA,181,6,175
290331,W00007696,W00007696,Output Areas and Small Areas,OASA,191,1,190
290332,W00007697,W00007697,Output Areas and Small Areas,OASA,250,10,240
290333,W00007698,W00007698,Output Areas and Small Areas,OASA,242,11,231
290334,W00007699,W00007699,Output Areas and Small Areas,OASA,194,11,183
290335,W00007700,W00007700,Output Areas and Small Areas,OASA,240,8,232
290336,W00007701,W00007701,Output Areas and Small Areas,OASA,224,7,217
290337,W00007702,W00007702,Output Areas and Small Areas,OASA,216,11,205
290338,W00007703,W00007703,Output Areas and Small Areas,OASA,256,9,247
290339,W00007704,W00007704,Output Areas and Small Areas,OASA,214,6,208
290340,W00007705,W00007705,Output Areas and Small Areas,OASA,249,10,239
290341,W00007706,W00007706,Output Areas and Small Areas,OASA,218,12,206
290342,W00007707,W00007707,Output Areas and Small Areas,OASA,156,10,146
290343,W00007708,W00007708,Output Areas and Small Areas,OASA,238,9,229
290344,W00007709,W00007709,Output Areas and Small Areas,OASA,293,18,275
290345,W00007710,W00007710,Output Areas and Small Areas,OASA,229,11,218
290346,W00007711,W00007711,Output Areas and Small Areas,OASA,202,8,194
290347,W00007712,W00007712,Output Areas and Small Areas,OASA,188,3,185
290348,W00007713,W00007713,Output Areas and Small Areas,OASA,236,2,234
290349,W00007714,W00007714,Output Areas and Small Areas,OASA,225,5,220
290350,W00007715,W00007715,Output Areas and Small Areas,OASA,249,17,232
290351,W00007716,W00007716,Output Areas and Small Areas,OASA,252,6,246
290352,W00007717,W00007717,Output Areas and Small Areas,OASA,245,8,237
290353,W00007718,W00007718,Output Areas and Small Areas,OASA,230,7,223
290354,W00007719,W00007719,Output Areas and Small Areas,OASA,253,14,239
290355,W00007720,W00007720,Output Areas and Small Areas,OASA,275,7,268
290356,W00007721,W00007721,Output Areas and Small Areas,OASA,157,5,152
290357,W00007722,W00007722,Output Areas and Small Areas,OASA,228,2,226
290358,W00007723,W00007723,Output Areas and Small Areas,OASA,217,7,210
290359,W00007724,W00007724,Output Areas and Small Areas,OASA,167,8,159
290360,W00007725,W00007725,Output Areas and Small Areas,OASA,237,9,228
290361,W00007726,W00007726,Output Areas and Small Areas,OASA,225,4,221
290362,W00007727,W00007727,Output Areas and Small Areas,OASA,264,10,254
290363,W00007728,W00007728,Output Areas and Small Areas,OASA,222,12,210
290364,W00007729,W00007729,Output Areas and Small Areas,OASA,171,4,167
290365,W00007730,W00007730,Output Areas and Small Areas,OASA,217,9,208
290366,W00007731,W00007731,Output Areas and Small Areas,OASA,223,17,206
290367,W00007732,W00007732,Output Areas and Small Areas,OASA,155,6,149
290368,W00007733,W00007733,Output Areas and Small Areas,OASA,204,10,194
290369,W00007734,W00007734,Output Areas and Small Areas,OASA,121,5,116
290370,W00007735,W00007735,Output Areas and Small Areas,OASA,251,7,244
290371,W00007736,W00007736,Output Areas and Small Areas,OASA,262,14,248
290372,W00007737,W00007737,Output Areas and Small Areas,OASA,223,8,215
290373,W00007738,W00007738,Output Areas and Small Areas,OASA,306,12,294
290374,W00007739,W00007739,Output Areas and Small Areas,OASA,191,10,181
290375,W00007740,W00007740,Output Areas and Small Areas,OASA,199,3,196
290376,W00007741,W00007741,Output Areas and Small Areas,OASA,276,15,261
290377,W00007742,W00007742,Output Areas and Small Areas,OASA,274,15,259
290378,W00007743,W00007743,Output Areas and Small Areas,OASA,251,12,239
290379,W00007744,W00007744,Output Areas and Small Areas,OASA,324,23,301
290380,W00007745,W00007745,Output Areas and Small Areas,OASA,227,7,220
290381,W00007746,W00007746,Output Areas and Small Areas,OASA,263,10,253
290382,W00007747,W00007747,Output Areas and Small Areas,OASA,279,11,268
290383,W00007748,W00007748,Output Areas and Small Areas,OASA,245,10,235
290384,W00007749,W00007749,Output Areas and Small Areas,OASA,205,7,198
290385,W00007750,W00007750,Output Areas and Small Areas,OASA,203,15,188
290386,W00007751,W00007751,Output Areas and Small Areas,OASA,346,16,330
290387,W00007752,W00007752,Output Areas and Small Areas,OASA,243,15,228
290388,W00007753,W00007753,Output Areas and Small Areas,OASA,230,12,218
290389,W00007754,W00007754,Output Areas and Small Areas,OASA,231,8,223
290390,W00007755,W00007755,Output Areas and Small Areas,OASA,260,10,250
290391,W00007756,W00007756,Output Areas and Small Areas,OASA,212,16,196
290392,W00007757,W00007757,Output Areas and Small Areas,OASA,245,15,230
290393,W00007758,W00007758,Output Areas and Small Areas,OASA,266,19,247
290394,W00007759,W00007759,Output Areas and Small Areas,OASA,241,13,228
290395,W00007760,W00007760,Output Areas and Small Areas,OASA,246,13,233
290396,W00007761,W00007761,Output Areas and Small Areas,OASA,252,22,230
290397,W00007762,W00007762,Output Areas and Small Areas,OASA,289,21,268
290398,W00007763,W00007763,Output Areas and Small Areas,OASA,271,12,259
290399,W00007764,W00007764,Output Areas and Small Areas,OASA,214,11,203
290400,W00007765,W00007765,Output Areas and Small Areas,OASA,163,9,154
290401,W00007766,W00007766,Output Areas and Small Areas,OASA,315,16,299
290402,W00007767,W00007767,Output Areas and Small Areas,OASA,302,21,281
290403,W00007768,W00007768,Output Areas and Small Areas,OASA,201,8,193
290404,W00007769,W00007769,Output Areas and Small Areas,OASA,229,3,226
290405,W00007770,W00007770,Output Areas and Small Areas,OASA,284,16,268
290406,W00007771,W00007771,Output Areas and Small Areas,OASA,238,14,224
290407,W00007772,W00007772,Output Areas and Small Areas,OASA,232,11,221
290408,W00007773,W00007773,Output Areas and Small Areas,OASA,214,12,202
290409,W00007774,W00007774,Output Areas and Small Areas,OASA,236,8,228
290410,W00007775,W00007775,Output Areas and Small Areas,OASA,190,8,182
290411,W00007776,W00007776,Output Areas and Small Areas,OASA,106,2,104
290412,W00007777,W00007777,Output Areas and Small Areas,OASA,245,7,238
290413,W00007778,W00007778,Output Areas and Small Areas,OASA,297,15,282
290414,W00007779,W00007779,Output Areas and Small Areas,OASA,241,13,228
290415,W00007780,W00007780,Output Areas and Small Areas,OASA,216,13,203
290416,W00007781,W00007781,Output Areas and Small Areas,OASA,190,7,183
290417,W00007782,W00007782,Output Areas and Small Areas,OASA,257,9,248
290418,W00007783,W00007783,Output Areas and Small Areas,OASA,247,6,241
290419,W00007784,W00007784,Output Areas and Small Areas,OASA,240,15,225
290420,W00007785,W00007785,Output Areas and Small Areas,OASA,172,8,164
290421,W00007786,W00007786,Output Areas and Small Areas,OASA,205,12,193
290422,W00007787,W00007787,Output Areas and Small Areas,OASA,217,7,210
290423,W00007788,W00007788,Output Areas and Small Areas,OASA,167,9,158
290424,W00007789,W00007789,Output Areas and Small Areas,OASA,241,6,235
290425,W00007790,W00007790,Output Areas and Small Areas,OASA,226,10,216
290426,W00007791,W00007791,Output Areas and Small Areas,OASA,213,6,207
290427,W00007792,W00007792,Output Areas and Small Areas,OASA,302,13,289
290428,W00007793,W00007793,Output Areas and Small Areas,OASA,257,10,247
290429,W00007794,W00007794,Output Areas and Small Areas,OASA,268,12,256
290430,W00007795,W00007795,Output Areas and Small Areas,OASA,258,14,244
290431,W00007796,W00007796,Output Areas and Small Areas,OASA,216,15,201
290432,W00007797,W00007797,Output Areas and Small Areas,OASA,288,13,275
290433,W00007798,W00007798,Output Areas and Small Areas,OASA,276,20,256
290434,W00007799,W00007799,Output Areas and Small Areas,OASA,330,27,303
290435,W00007800,W00007800,Output Areas and Small Areas,OASA,250,11,239
290436,W00007801,W00007801,Output Areas and Small Areas,OASA,214,11,203
290437,W00007802,W00007802,Output Areas and Small Areas,OASA,233,12,221
290438,W00007803,W00007803,Output Areas and Small Areas,OASA,274,5,269
290439,W00007804,W00007804,Output Areas and Small Areas,OASA,237,15,222
290440,W00007805,W00007805,Output Areas and Small Areas,OASA,209,14,195
290441,W00007806,W00007806,Output Areas and Small Areas,OASA,246,16,230
290442,W00007807,W00007807,Output Areas and Small Areas,OASA,232,12,220
290443,W00007808,W00007808,Output Areas and Small Areas,OASA,238,9,229
290444,W00007809,W00007809,Output Areas and Small Areas,OASA,224,19,205
290445,W00007810,W00007810,Output Areas and Small Areas,OASA,204,8,196
290446,W00007811,W00007811,Output Areas and Small Areas,OASA,285,17,268
290447,W00007812,W00007812,Output Areas and Small Areas,OASA,239,11,228
290448,W00007813,W00007813,Output Areas and Small Areas,OASA,212,14,198
290449,W00007814,W00007814,Output Areas and Small Areas,OASA,321,22,299
290450,W00007815,W00007815,Output Areas and Small Areas,OASA,234,17,217
290451,W00007816,W00007816,Output Areas and Small Areas,OASA,245,20,225
290452,W00007817,W00007817,Output Areas and Small Areas,OASA,242,15,227
290453,W00007818,W00007818,Output Areas and Small Areas,OASA,292,17,275
290454,W00007819,W00007819,Output Areas and Small Areas,OASA,128,10,118
290455,W00007820,W00007820,Output Areas and Small Areas,OASA,280,7,273
290456,W00007821,W00007821,Output Areas and Small Areas,OASA,222,9,213
290457,W00007822,W00007822,Output Areas and Small Areas,OASA,224,5,219
290458,W00007823,W00007823,Output Areas and Small Areas,OASA,326,21,305
290459,W00007824,W00007824,Output Areas and Small Areas,OASA,219,5,214
290460,W00007825,W00007825,Output Areas and Small Areas,OASA,254,10,244
290461,W00007826,W00007826,Output Areas and Small Areas,OASA,250,15,235
290462,W00007827,W00007827,Output Areas and Small Areas,OASA,215,6,209
290463,W00007828,W00007828,Output Areas and Small Areas,OASA,240,8,232
290464,W00007829,W00007829,Output Areas and Small Areas,OASA,265,12,253
290465,W00007830,W00007830,Output Areas and Small Areas,OASA,236,10,226
290466,W00007831,W00007831,Output Areas and Small Areas,OASA,255,12,243
290467,W00007832,W00007832,Output Areas and Small Areas,OASA,245,11,234
290468,W00007833,W00007833,Output Areas and Small Areas,OASA,231,14,217
290469,W00007834,W00007834,Output Areas and Small Areas,OASA,223,11,212
290470,W00007835,W00007835,Output Areas and Small Areas,OASA,243,11,232
290471,W00007836,W00007836,Output Areas and Small Areas,OASA,300,12,288
290472,W00007837,W00007837,Output Areas and Small Areas,OASA,239,8,231
290473,W00007838,W00007838,Output Areas and Small Areas,OASA,255,7,248
290474,W00007839,W00007839,Output Areas and Small Areas,OASA,309,20,289
290475,W00007840,W00007840,Output Areas and Small Areas,OASA,275,10,265
290476,W00007841,W00007841,Output Areas and Small Areas,OASA,267,10,257
290477,W00007842,W00007842,Output Areas and Small Areas,OASA,230,13,217
290478,W00007843,W00007843,Output Areas and Small Areas,OASA,222,8,214
290479,W00007844,W00007844,Output Areas and Small Areas,OASA,277,11,266
290480,W00007845,W00007845,Output Areas and Small Areas,OASA,254,17,237
290481,W00007846,W00007846,Output Areas and Small Areas,OASA,245,6,239
290482,W00007847,W00007847,Output Areas and Small Areas,OASA,258,12,246
290483,W00007848,W00007848,Output Areas and Small Areas,OASA,247,6,241
290484,W00007849,W00007849,Output Areas and Small Areas,OASA,245,5,240
290485,W00007850,W00007850,Output Areas and Small Areas,OASA,240,14,226
290486,W00007851,W00007851,Output Areas and Small Areas,OASA,267,12,255
290487,W00007852,W00007852,Output Areas and Small Areas,OASA,118,4,114
290488,W00007853,W00007853,Output Areas and Small Areas,OASA,212,6,206
290489,W00007854,W00007854,Output Areas and Small Areas,OASA,193,5,188
290490,W00007855,W00007855,Output Areas and Small Areas,OASA,218,8,210
290491,W00007856,W00007856,Output Areas and Small Areas,OASA,193,8,185
290492,W00007857,W00007857,Output Areas and Small Areas,OASA,402,21,381
290493,W00007858,W00007858,Output Areas and Small Areas,OASA,469,17,452
290494,W00007859,W00007859,Output Areas and Small Areas,OASA,229,8,221
290495,W00007860,W00007860,Output Areas and Small Areas,OASA,264,10,254
290496,W00007861,W00007861,Output Areas and Small Areas,OASA,235,6,229
290497,W00007862,W00007862,Output Areas and Small Areas,OASA,400,19,381
290498,W00007863,W00007863,Output Areas and Small Areas,OASA,222,10,212
290499,W00007864,W00007864,Output Areas and Small Areas,OASA,282,11,271
290500,W00007865,W00007865,Output Areas and Small Areas,OASA,221,12,209
290501,W00007866,W00007866,Output Areas and Small Areas,OASA,248,7,241
290502,W00007867,W00007867,Output Areas and Small Areas,OASA,364,12,352
290503,W00007868,W00007868,Output Areas and Small Areas,OASA,243,15,228
290504,W00007869,W00007869,Output Areas and Small Areas,OASA,249,11,238
290505,W00007870,W00007870,Output Areas and Small Areas,OASA,249,16,233
290506,W00007871,W00007871,Output Areas and Small Areas,OASA,215,15,200
290507,W00007872,W00007872,Output Areas and Small Areas,OASA,246,15,231
290508,W00007873,W00007873,Output Areas and Small Areas,OASA,233,15,218
290509,W00007874,W00007874,Output Areas and Small Areas,OASA,224,14,210
290510,W00007875,W00007875,Output Areas and Small Areas,OASA,208,10,198
290511,W00007876,W00007876,Output Areas and Small Areas,OASA,270,15,255
290512,W00007877,W00007877,Output Areas and Small Areas,OASA,317,21,296
290513,W00007878,W00007878,Output Areas and Small Areas,OASA,275,11,264
290514,W00007879,W00007879,Output Areas and Small Areas,OASA,373,22,351
290515,W00007880,W00007880,Output Areas and Small Areas,OASA,101,5,96
290516,W00007881,W00007881,Output Areas and Small Areas,OASA,254,12,242
290517,W00007882,W00007882,Output Areas and Small Areas,OASA,255,14,241
290518,W00007883,W00007883,Output Areas and Small Areas,OASA,266,19,247
290519,W00007884,W00007884,Output Areas and Small Areas,OASA,274,19,255
290520,W00007885,W00007885,Output Areas and Small Areas,OASA,222,6,216
290521,W00007886,W00007886,Output Areas and Small Areas,OASA,237,9,228
290522,W00007887,W00007887,Output Areas and Small Areas,OASA,271,14,257
290523,W00007888,W00007888,Output Areas and Small Areas,OASA,165,3,162
290524,W00007889,W00007889,Output Areas and Small Areas,OASA,250,12,238
290525,W00007890,W00007890,Output Areas and Small Areas,OASA,218,7,211
290526,W00007891,W00007891,Output Areas and Small Areas,OASA,222,6,216
290527,W00007892,W00007892,Output Areas and Small Areas,OASA,194,7,187
290528,W00007893,W00007893,Output Areas and Small Areas,OASA,259,13,246
290529,W00007894,W00007894,Output Areas and Small Areas,OASA,253,14,239
290530,W00007895,W00007895,Output Areas and Small Areas,OASA,290,13,277
290531,W00007896,W00007896,Output Areas and Small Areas,OASA,175,3,172
290532,W00007897,W00007897,Output Areas and Small Areas,OASA,230,8,222
290533,W00007898,W00007898,Output Areas and Small Areas,OASA,248,15,233
290534,W00007899,W00007899,Output Areas and Small Areas,OASA,254,10,244
290535,W00007900,W00007900,Output Areas and Small Areas,OASA,259,16,243
290536,W00007901,W00007901,Output Areas and Small Areas,OASA,243,15,228
290537,W00007902,W00007902,Output Areas and Small Areas,OASA,242,6,236
290538,W00007903,W00007903,Output Areas and Small Areas,OASA,285,15,270
290539,W00007904,W00007904,Output Areas and Small Areas,OASA,246,17,229
290540,W00007905,W00007905,Output Areas and Small Areas,OASA,247,12,235
290541,W00007906,W00007906,Output Areas and Small Areas,OASA,242,6,236
290542,W00007907,W00007907,Output Areas and Small Areas,OASA,278,14,264
290543,W00007908,W00007908,Output Areas and Small Areas,OASA,231,3,228
290544,W00007909,W00007909,Output Areas and Small Areas,OASA,256,16,240
290545,W00007910,W00007910,Output Areas and Small Areas,OASA,252,10,242
290546,W00007911,W00007911,Output Areas and Small Areas,OASA,232,6,226
290547,W00007912,W00007912,Output Areas and Small Areas,OASA,302,16,286
290548,W00007913,W00007913,Output Areas and Small Areas,OASA,248,5,243
290549,W00007914,W00007914,Output Areas and Small Areas,OASA,214,14,200
290550,W00007915,W00007915,Output Areas and Small Areas,OASA,211,9,202
290551,W00007916,W00007916,Output Areas and Small Areas,OASA,247,13,234
290552,W00007918,W00007918,Output Areas and Small Areas,OASA,247,15,232
290553,W00007919,W00007919,Output Areas and Small Areas,OASA,220,10,210
290554,W00007920,W00007920,Output Areas and Small Areas,OASA,259,9,250
290555,W00007921,W00007921,Output Areas and Small Areas,OASA,214,10,204
290556,W00007922,W00007922,Output Areas and Small Areas,OASA,269,6,263
290557,W00007923,W00007923,Output Areas and Small Areas,OASA,225,11,214
290558,W00007924,W00007924,Output Areas and Small Areas,OASA,240,7,233
290559,W00007925,W00007925,Output Areas and Small Areas,OASA,199,14,185
290560,W00007926,W00007926,Output Areas and Small Areas,OASA,275,12,263
290561,W00007927,W00007927,Output Areas and Small Areas,OASA,251,6,245
290562,W00007928,W00007928,Output Areas and Small Areas,OASA,238,9,229
290563,W00007929,W00007929,Output Areas and Small Areas,OASA,151,11,140
290564,W00007930,W00007930,Output Areas and Small Areas,OASA,284,16,268
290565,W00007931,W00007931,Output Areas and Small Areas,OASA,209,7,202
290566,W00007932,W00007932,Output Areas and Small Areas,OASA,224,7,217
290567,W00007933,W00007933,Output Areas and Small Areas,OASA,231,17,214
290568,W00007934,W00007934,Output Areas and Small Areas,OASA,255,18,237
290569,W00007935,W00007935,Output Areas and Small Areas,OASA,409,16,393
290570,W00007936,W00007936,Output Areas and Small Areas,OASA,225,7,218
290571,W00007937,W00007937,Output Areas and Small Areas,OASA,207,12,195
290572,W00007938,W00007938,Output Areas and Small Areas,OASA,251,12,239
290573,W00007939,W00007939,Output Areas and Small Areas,OASA,218,9,209
290574,W00007940,W00007940,Output Areas and Small Areas,OASA,207,7,200
290575,W00007941,W00007941,Output Areas and Small Areas,OASA,255,10,245
290576,W00007942,W00007942,Output Areas and Small Areas,OASA,245,11,234
290577,W00007943,W00007943,Output Areas and Small Areas,OASA,234,25,209
290578,W00007944,W00007944,Output Areas and Small Areas,OASA,247,10,237
290579,W00007945,W00007945,Output Areas and Small Areas,OASA,218,16,202
290580,W00007946,W00007946,Output Areas and Small Areas,OASA,226,14,212
290581,W00007947,W00007947,Output Areas and Small Areas,OASA,312,20,292
290582,W00007948,W00007948,Output Areas and Small Areas,OASA,267,16,251
290583,W00007949,W00007949,Output Areas and Small Areas,OASA,251,10,241
290584,W00007950,W00007950,Output Areas and Small Areas,OASA,242,11,231
290585,W00007951,W00007951,Output Areas and Small Areas,OASA,268,14,254
290586,W00007952,W00007952,Output Areas and Small Areas,OASA,229,9,220
290587,W00007953,W00007953,Output Areas and Small Areas,OASA,245,15,230
290588,W00007954,W00007954,Output Areas and Small Areas,OASA,261,16,245
290589,W00007955,W00007955,Output Areas and Small Areas,OASA,234,5,229
290590,W00007956,W00007956,Output Areas and Small Areas,OASA,281,16,265
290591,W00007957,W00007957,Output Areas and Small Areas,OASA,257,6,251
290592,W00007958,W00007958,Output Areas and Small Areas,OASA,227,6,221
290593,W00007959,W00007959,Output Areas and Small Areas,OASA,293,10,283
290594,W00007960,W00007960,Output Areas and Small Areas,OASA,243,5,238
290595,W00007961,W00007961,Output Areas and Small Areas,OASA,261,5,256
290596,W00007962,W00007962,Output Areas and Small Areas,OASA,254,18,236
290597,W00007963,W00007963,Output Areas and Small Areas,OASA,244,11,233
290598,W00007964,W00007964,Output Areas and Small Areas,OASA,225,3,222
290599,W00007965,W00007965,Output Areas and Small Areas,OASA,252,7,245
290600,W00007966,W00007966,Output Areas and Small Areas,OASA,239,13,226
290601,W00007967,W00007967,Output Areas and Small Areas,OASA,254,20,234
290602,W00007968,W00007968,Output Areas and Small Areas,OASA,231,7,224
290603,W00007969,W00007969,Output Areas and Small Areas,OASA,208,8,200
290604,W00007970,W00007970,Output Areas and Small Areas,OASA,205,7,198
290605,W00007971,W00007971,Output Areas and Small Areas,OASA,179,7,172
290606,W00007972,W00007972,Output Areas and Small Areas,OASA,211,7,204
290607,W00007973,W00007973,Output Areas and Small Areas,OASA,200,7,193
290608,W00007974,W00007974,Output Areas and Small Areas,OASA,170,3,167
290609,W00007975,W00007975,Output Areas and Small Areas,OASA,247,10,237
290610,W00007976,W00007976,Output Areas and Small Areas,OASA,197,9,188
290611,W00007977,W00007977,Output Areas and Small Areas,OASA,220,17,203
290612,W00007978,W00007978,Output Areas and Small Areas,OASA,181,6,175
290613,W00007979,W00007979,Output Areas and Small Areas,OASA,334,18,316
290614,W00007980,W00007980,Output Areas and Small Areas,OASA,198,8,190
290615,W00007981,W00007981,Output Areas and Small Areas,OASA,257,14,243
290616,W00007982,W00007982,Output Areas and Small Areas,OASA,210,9,201
290617,W00007983,W00007983,Output Areas and Small Areas,OASA,239,18,221
290618,W00007984,W00007984,Output Areas and Small Areas,OASA,186,3,183
290619,W00007985,W00007985,Output Areas and Small Areas,OASA,308,15,293
290620,W00007986,W00007986,Output Areas and Small Areas,OASA,209,4,205
290621,W00007987,W00007987,Output Areas and Small Areas,OASA,258,4,254
290622,W00007988,W00007988,Output Areas and Small Areas,OASA,236,6,230
290623,W00007989,W00007989,Output Areas and Small Areas,OASA,231,9,222
290624,W00007990,W00007990,Output Areas and Small Areas,OASA,233,14,219
290625,W00007991,W00007991,Output Areas and Small Areas,OASA,245,11,234
290626,W00007992,W00007992,Output Areas and Small Areas,OASA,235,16,219
290627,W00007993,W00007993,Output Areas and Small Areas,OASA,215,11,204
290628,W00007994,W00007994,Output Areas and Small Areas,OASA,208,9,199
290629,W00007995,W00007995,Output Areas and Small Areas,OASA,237,12,225
290630,W00007996,W00007996,Output Areas and Small Areas,OASA,230,6,224
290631,W00007997,W00007997,Output Areas and Small Areas,OASA,206,8,198
290632,W00007998,W00007998,Output Areas and Small Areas,OASA,208,14,194
290633,W00007999,W00007999,Output Areas and Small Areas,OASA,216,7,209
290634,W00008000,W00008000,Output Areas and Small Areas,OASA,237,18,219
290635,W00008001,W00008001,Output Areas and Small Areas,OASA,251,25,226
290636,W00008002,W00008002,Output Areas and Small Areas,OASA,277,21,256
290637,W00008003,W00008003,Output Areas and Small Areas,OASA,192,12,180
290638,W00008004,W00008004,Output Areas and Small Areas,OASA,217,7,210
290639,W00008005,W00008005,Output Areas and Small Areas,OASA,265,17,248
290640,W00008006,W00008006,Output Areas and Small Areas,OASA,242,15,227
290641,W00008007,W00008007,Output Areas and Small Areas,OASA,275,9,266
290642,W00008008,W00008008,Output Areas and Small Areas,OASA,254,6,248
290643,W00008009,W00008009,Output Areas and Small Areas,OASA,219,13,206
290644,W00008011,W00008011,Output Areas and Small Areas,OASA,282,18,264
290645,W00008012,W00008012,Output Areas and Small Areas,OASA,358,29,329
290646,W00008013,W00008013,Output Areas and Small Areas,OASA,284,20,264
290647,W00008014,W00008014,Output Areas and Small Areas,OASA,114,1,113
290648,W00008015,W00008015,Output Areas and Small Areas,OASA,128,3,125
290649,W00008016,W00008016,Output Areas and Small Areas,OASA,121,6,115
290650,W00008017,W00008017,Output Areas and Small Areas,OASA,242,21,221
290651,W00008018,W00008018,Output Areas and Small Areas,OASA,253,10,243
290652,W00008019,W00008019,Output Areas and Small Areas,OASA,210,7,203
290653,W00008020,W00008020,Output Areas and Small Areas,OASA,251,7,244
290654,W00008021,W00008021,Output Areas and Small Areas,OASA,274,9,265
290655,W00008022,W00008022,Output Areas and Small Areas,OASA,267,16,251
290656,W00008023,W00008023,Output Areas and Small Areas,OASA,214,11,203
290657,W00008024,W00008024,Output Areas and Small Areas,OASA,224,8,216
290658,W00008025,W00008025,Output Areas and Small Areas,OASA,217,12,205
290659,W00008026,W00008026,Output Areas and Small Areas,OASA,237,9,228
290660,W00008027,W00008027,Output Areas and Small Areas,OASA,159,5,154
290661,W00008028,W00008028,Output Areas and Small Areas,OASA,236,2,234
290662,W00008029,W00008029,Output Areas and Small Areas,OASA,262,10,252
290663,W00008030,W00008030,Output Areas and Small Areas,OASA,157,10,147
290664,W00008031,W00008031,Output Areas and Small Areas,OASA,218,6,212
290665,W00008032,W00008032,Output Areas and Small Areas,OASA,244,11,233
290666,W00008033,W00008033,Output Areas and Small Areas,OASA,244,12,232
290667,W00008034,W00008034,Output Areas and Small Areas,OASA,205,9,196
290668,W00008035,W00008035,Output Areas and Small Areas,OASA,245,10,235
290669,W00008036,W00008036,Output Areas and Small Areas,OASA,347,15,332
290670,W00008037,W00008037,Output Areas and Small Areas,OASA,262,12,250
290671,W00008038,W00008038,Output Areas and Small Areas,OASA,235,17,218
290672,W00008039,W00008039,Output Areas and Small Areas,OASA,124,6,118
290673,W00008040,W00008040,Output Areas and Small Areas,OASA,302,10,292
290674,W00008041,W00008041,Output Areas and Small Areas,OASA,237,9,228
290675,W00008042,W00008042,Output Areas and Small Areas,OASA,252,13,239
290676,W00008043,W00008043,Output Areas and Small Areas,OASA,267,12,255
290677,W00008044,W00008044,Output Areas and Small Areas,OASA,243,1,242
290678,W00008045,W00008045,Output Areas and Small Areas,OASA,272,11,261
290679,W00008046,W00008046,Output Areas and Small Areas,OASA,267,12,255
290680,W00008047,W00008047,Output Areas and Small Areas,OASA,356,20,336
290681,W00008048,W00008048,Output Areas and Small Areas,OASA,361,12,349
290682,W00008049,W00008049,Output Areas and Small Areas,OASA,322,24,298
290683,W00008050,W00008050,Output Areas and Small Areas,OASA,200,11,189
290684,W00008051,W00008051,Output Areas and Small Areas,OASA,262,22,240
290685,W00008052,W00008052,Output Areas and Small Areas,OASA,251,11,240
290686,W00008053,W00008053,Output Areas and Small Areas,OASA,235,10,225
290687,W00008054,W00008054,Output Areas and Small Areas,OASA,323,13,310
290688,W00008055,W00008055,Output Areas and Small Areas,OASA,254,8,246
290689,W00008056,W00008056,Output Areas and Small Areas,OASA,165,8,157
290690,W00008057,W00008057,Output Areas and Small Areas,OASA,286,14,272
290691,W00008058,W00008058,Output Areas and Small Areas,OASA,200,9,191
290692,W00008059,W00008059,Output Areas and Small Areas,OASA,272,7,265
290693,W00008060,W00008060,Output Areas and Small Areas,OASA,248,12,236
290694,W00008061,W00008061,Output Areas and Small Areas,OASA,227,10,217
290695,W00008062,W00008062,Output Areas and Small Areas,OASA,240,12,228
290696,W00008063,W00008063,Output Areas and Small Areas,OASA,226,15,211
290697,W00008064,W00008064,Output Areas and Small Areas,OASA,242,11,231
290698,W00008065,W00008065,Output Areas and Small Areas,OASA,279,9,270
290699,W00008066,W00008066,Output Areas and Small Areas,OASA,235,12,223
290700,W00008067,W00008067,Output Areas and Small Areas,OASA,291,18,273
290701,W00008068,W00008068,Output Areas and Small Areas,OASA,98,4,94
290702,W00008069,W00008069,Output Areas and Small Areas,OASA,219,16,203
290703,W00008070,W00008070,Output Areas and Small Areas,OASA,271,15,256
290704,W00008071,W00008071,Output Areas and Small Areas,OASA,171,14,157
290705,W00008072,W00008072,Output Areas and Small Areas,OASA,261,8,253
290706,W00008073,W00008073,Output Areas and Small Areas,OASA,221,12,209
290707,W00008074,W00008074,Output Areas and Small Areas,OASA,212,16,196
290708,W00008075,W00008075,Output Areas and Small Areas,OASA,255,10,245
290709,W00008076,W00008076,Output Areas and Small Areas,OASA,272,11,261
290710,W00008077,W00008077,Output Areas and Small Areas,OASA,255,13,242
290711,W00008078,W00008078,Output Areas and Small Areas,OASA,240,11,229
290712,W00008079,W00008079,Output Areas and Small Areas,OASA,338,20,318
290713,W00008080,W00008080,Output Areas and Small Areas,OASA,382,18,364
290714,W00008081,W00008081,Output Areas and Small Areas,OASA,270,12,258
290715,W00008082,W00008082,Output Areas and Small Areas,OASA,281,16,265
290716,W00008083,W00008083,Output Areas and Small Areas,OASA,317,22,295
290717,W00008084,W00008084,Output Areas and Small Areas,OASA,371,17,354
290718,W00008085,W00008085,Output Areas and Small Areas,OASA,234,10,224
290719,W00008086,W00008086,Output Areas and Small Areas,OASA,266,12,254
290720,W00008087,W00008087,Output Areas and Small Areas,OASA,240,10,230
290721,W00008088,W00008088,Output Areas and Small Areas,OASA,200,4,196
290722,W00008089,W00008089,Output Areas and Small Areas,OASA,255,16,239
290723,W00008090,W00008090,Output Areas and Small Areas,OASA,289,18,271
290724,W00008091,W00008091,Output Areas and Small Areas,OASA,262,11,251
290725,W00008092,W00008092,Output Areas and Small Areas,OASA,299,12,287
290726,W00008093,W00008093,Output Areas and Small Areas,OASA,169,8,161
290727,W00008094,W00008094,Output Areas and Small Areas,OASA,281,23,258
290728,W00008096,W00008096,Output Areas and Small Areas,OASA,384,11,373
290729,W00008097,W00008097,Output Areas and Small Areas,OASA,156,3,153
290730,W00008099,W00008099,Output Areas and Small Areas,OASA,237,6,231
290731,W00008100,W00008100,Output Areas and Small Areas,OASA,300,14,286
290732,W00008101,W00008101,Output Areas and Small Areas,OASA,309,8,301
290733,W00008102,W00008102,Output Areas and Small Areas,OASA,287,10,277
290734,W00008103,W00008103,Output Areas and Small Areas,OASA,260,8,252
290735,W00008104,W00008104,Output Areas and Small Areas,OASA,226,8,218
290736,W00008105,W00008105,Output Areas and Small Areas,OASA,286,15,271
290737,W00008106,W00008106,Output Areas and Small Areas,OASA,276,18,258
290738,W00008107,W00008107,Output Areas and Small Areas,OASA,221,16,205
290739,W00008108,W00008108,Output Areas and Small Areas,OASA,197,11,186
290740,W00008109,W00008109,Output Areas and Small Areas,OASA,240,14,226
290741,W00008110,W00008110,Output Areas and Small Areas,OASA,237,20,217
290742,W00008111,W00008111,Output Areas and Small Areas,OASA,251,23,228
290743,W00008112,W00008112,Output Areas and Small Areas,OASA,265,10,255
290744,W00008113,W00008113,Output Areas and Small Areas,OASA,220,4,216
290745,W00008114,W00008114,Output Areas and Small Areas,OASA,214,10,204
290746,W00008115,W00008115,Output Areas and Small Areas,OASA,237,11,226
290747,W00008116,W00008116,Output Areas and Small Areas,OASA,233,13,220
290748,W00008117,W00008117,Output Areas and Small Areas,OASA,204,15,189
290749,W00008118,W00008118,Output Areas and Small Areas,OASA,210,9,201
290750,W00008119,W00008119,Output Areas and Small Areas,OASA,250,8,242
290751,W00008120,W00008120,Output Areas and Small Areas,OASA,225,16,209
290752,W00008121,W00008121,Output Areas and Small Areas,OASA,200,12,188
290753,W00008122,W00008122,Output Areas and Small Areas,OASA,230,27,203
290754,W00008123,W00008123,Output Areas and Small Areas,OASA,219,4,215
290755,W00008124,W00008124,Output Areas and Small Areas,OASA,215,7,208
290756,W00008125,W00008125,Output Areas and Small Areas,OASA,189,6,183
290757,W00008126,W00008126,Output Areas and Small Areas,OASA,222,9,213
290758,W00008127,W00008127,Output Areas and Small Areas,OASA,197,4,193
290759,W00008128,W00008128,Output Areas and Small Areas,OASA,233,12,221
290760,W00008129,W00008129,Output Areas and Small Areas,OASA,273,2,271
290761,W00008130,W00008130,Output Areas and Small Areas,OASA,300,8,292
290762,W00008131,W00008131,Output Areas and Small Areas,OASA,268,13,255
290763,W00008132,W00008132,Output Areas and Small Areas,OASA,285,11,274
290764,W00008133,W00008133,Output Areas and Small Areas,OASA,401,24,377
290765,W00008134,W00008134,Output Areas and Small Areas,OASA,391,21,370
290766,W00008135,W00008135,Output Areas and Small Areas,OASA,308,15,293
290767,W00008136,W00008136,Output Areas and Small Areas,OASA,199,10,189
290768,W00008137,W00008137,Output Areas and Small Areas,OASA,314,22,292
290769,W00008138,W00008138,Output Areas and Small Areas,OASA,282,12,270
290770,W00008139,W00008139,Output Areas and Small Areas,OASA,315,15,300
290771,W00008140,W00008140,Output Areas and Small Areas,OASA,252,17,235
290772,W00008141,W00008141,Output Areas and Small Areas,OASA,298,17,281
290773,W00008142,W00008142,Output Areas and Small Areas,OASA,250,12,238
290774,W00008143,W00008143,Output Areas and Small Areas,OASA,258,12,246
290775,W00008144,W00008144,Output Areas and Small Areas,OASA,200,9,191
290776,W00008145,W00008145,Output Areas and Small Areas,OASA,220,5,215
290777,W00008146,W00008146,Output Areas and Small Areas,OASA,172,6,166
290778,W00008147,W00008147,Output Areas and Small Areas,OASA,269,22,247
290779,W00008148,W00008148,Output Areas and Small Areas,OASA,308,21,287
290780,W00008149,W00008149,Output Areas and Small Areas,OASA,188,6,182
290781,W00008150,W00008150,Output Areas and Small Areas,OASA,336,26,310
290782,W00008151,W00008151,Output Areas and Small Areas,OASA,203,12,191
290783,W00008152,W00008152,Output Areas and Small Areas,OASA,222,19,203
290784,W00008153,W00008153,Output Areas and Small Areas,OASA,110,7,103
290785,W00008154,W00008154,Output Areas and Small Areas,OASA,209,8,201
290786,W00008155,W00008155,Output Areas and Small Areas,OASA,235,16,219
290787,W00008157,W00008157,Output Areas and Small Areas,OASA,387,19,368
290788,W00008159,W00008159,Output Areas and Small Areas,OASA,410,23,387
290789,W00008160,W00008160,Output Areas and Small Areas,OASA,374,22,352
290790,W00008161,W00008161,Output Areas and Small Areas,OASA,275,10,265
290791,W00008162,W00008162,Output Areas and Small Areas,OASA,258,19,239
290792,W00008163,W00008163,Output Areas and Small Areas,OASA,216,9,207
290793,W00008164,W00008164,Output Areas and Small Areas,OASA,309,12,297
290794,W00008165,W00008165,Output Areas and Small Areas,OASA,330,16,314
290795,W00008166,W00008166,Output Areas and Small Areas,OASA,302,13,289
290796,W00008167,W00008167,Output Areas and Small Areas,OASA,278,12,266
290797,W00008168,W00008168,Output Areas and Small Areas,OASA,280,13,267
290798,W00008169,W00008169,Output Areas and Small Areas,OASA,302,8,294
290799,W00008170,W00008170,Output Areas and Small Areas,OASA,275,11,264
290800,W00008171,W00008171,Output Areas and Small Areas,OASA,297,16,281
290801,W00008172,W00008172,Output Areas and Small Areas,OASA,303,16,287
290802,W00008173,W00008173,Output Areas and Small Areas,OASA,269,13,256
290803,W00008174,W00008174,Output Areas and Small Areas,OASA,254,13,241
290804,W00008175,W00008175,Output Areas and Small Areas,OASA,204,4,200
290805,W00008176,W00008176,Output Areas and Small Areas,OASA,231,14,217
290806,W00008177,W00008177,Output Areas and Small Areas,OASA,263,17,246
290807,W00008178,W00008178,Output Areas and Small Areas,OASA,253,7,246
290808,W00008179,W00008179,Output Areas and Small Areas,OASA,214,17,197
290809,W00008180,W00008180,Output Areas and Small Areas,OASA,304,8,296
290810,W00008181,W00008181,Output Areas and Small Areas,OASA,272,17,255
290811,W00008182,W00008182,Output Areas and Small Areas,OASA,327,27,300
290812,W00008183,W00008183,Output Areas and Small Areas,OASA,288,8,280
290813,W00008184,W00008184,Output Areas and Small Areas,OASA,187,7,180
290814,W00008185,W00008185,Output Areas and Small Areas,OASA,253,16,237
290815,W00008186,W00008186,Output Areas and Small Areas,OASA,256,11,245
290816,W00008187,W00008187,Output Areas and Small Areas,OASA,258,20,238
290817,W00008188,W00008188,Output Areas and Small Areas,OASA,194,11,183
290818,W00008189,W00008189,Output Areas and Small Areas,OASA,237,11,226
290819,W00008190,W00008190,Output Areas and Small Areas,OASA,249,16,233
290820,W00008191,W00008191,Output Areas and Small Areas,OASA,279,10,269
290821,W00008192,W00008192,Output Areas and Small Areas,OASA,287,18,269
290822,W00008193,W00008193,Output Areas and Small Areas,OASA,230,8,222
290823,W00008194,W00008194,Output Areas and Small Areas,OASA,233,13,220
290824,W00008195,W00008195,Output Areas and Small Areas,OASA,179,5,174
290825,W00008196,W00008196,Output Areas and Small Areas,OASA,291,12,279
290826,W00008197,W00008197,Output Areas and Small Areas,OASA,272,15,257
290827,W00008198,W00008198,Output Areas and Small Areas,OASA,212,8,204
290828,W00008199,W00008199,Output Areas and Small Areas,OASA,245,14,231
290829,W00008200,W00008200,Output Areas and Small Areas,OASA,243,8,235
290830,W00008201,W00008201,Output Areas and Small Areas,OASA,265,7,258
290831,W00008202,W00008202,Output Areas and Small Areas,OASA,283,16,267
290832,W00008203,W00008203,Output Areas and Small Areas,OASA,248,7,241
290833,W00008204,W00008204,Output Areas and Small Areas,OASA,208,4,204
290834,W00008205,W00008205,Output Areas and Small Areas,OASA,162,5,157
290835,W00008206,W00008206,Output Areas and Small Areas,OASA,331,12,319
290836,W00008207,W00008207,Output Areas and Small Areas,OASA,253,6,247
290837,W00008208,W00008208,Output Areas and Small Areas,OASA,227,12,215
290838,W00008209,W00008209,Output Areas and Small Areas,OASA,169,2,167
290839,W00008210,W00008210,Output Areas and Small Areas,OASA,191,7,184
290840,W00008211,W00008211,Output Areas and Small Areas,OASA,164,2,162
290841,W00008212,W00008212,Output Areas and Small Areas,OASA,277,8,269
290842,W00008213,W00008213,Output Areas and Small Areas,OASA,274,19,255
290843,W00008214,W00008214,Output Areas and Small Areas,OASA,326,16,310
290844,W00008215,W00008215,Output Areas and Small Areas,OASA,286,8,278
290845,W00008216,W00008216,Output Areas and Small Areas,OASA,287,9,278
290846,W00008217,W00008217,Output Areas and Small Areas,OASA,187,7,180
290847,W00008218,W00008218,Output Areas and Small Areas,OASA,271,11,260
290848,W00008219,W00008219,Output Areas and Small Areas,OASA,172,9,163
290849,W00008220,W00008220,Output Areas and Small Areas,OASA,204,12,192
290850,W00008222,W00008222,Output Areas and Small Areas,OASA,329,29,300
290851,W00008223,W00008223,Output Areas and Small Areas,OASA,246,17,229
290852,W00008224,W00008224,Output Areas and Small Areas,OASA,281,9,272
290853,W00008225,W00008225,Output Areas and Small Areas,OASA,227,20,207
290854,W00008226,W00008226,Output Areas and Small Areas,OASA,245,6,239
290855,W00008227,W00008227,Output Areas and Small Areas,OASA,202,9,193
290856,W00008228,W00008228,Output Areas and Small Areas,OASA,227,13,214
290857,W00008229,W00008229,Output Areas and Small Areas,OASA,273,13,260
290858,W00008230,W00008230,Output Areas and Small Areas,OASA,227,10,217
290859,W00008231,W00008231,Output Areas and Small Areas,OASA,260,12,248
290860,W00008232,W00008232,Output Areas and Small Areas,OASA,314,12,302
290861,W00008233,W00008233,Output Areas and Small Areas,OASA,253,15,238
290862,W00008234,W00008234,Output Areas and Small Areas,OASA,312,19,293
290863,W00008235,W00008235,Output Areas and Small Areas,OASA,271,15,256
290864,W00008236,W00008236,Output Areas and Small Areas,OASA,270,5,265
290865,W00008237,W00008237,Output Areas and Small Areas,OASA,293,20,273
290866,W00008238,W00008238,Output Areas and Small Areas,OASA,284,23,261
290867,W00008239,W00008239,Output Areas and Small Areas,OASA,317,16,301
290868,W00008240,W00008240,Output Areas and Small Areas,OASA,246,12,234
290869,W00008241,W00008241,Output Areas and Small Areas,OASA,298,15,283
290870,W00008242,W00008242,Output Areas and Small Areas,OASA,339,16,323
290871,W00008243,W00008243,Output Areas and Small Areas,OASA,319,13,306
290872,W00008244,W00008244,Output Areas and Small Areas,OASA,179,7,172
290873,W00008245,W00008245,Output Areas and Small Areas,OASA,211,9,202
290874,W00008246,W00008246,Output Areas and Small Areas,OASA,283,11,272
290875,W00008247,W00008247,Output Areas and Small Areas,OASA,246,10,236
290876,W00008248,W00008248,Output Areas and Small Areas,OASA,237,16,221
290877,W00008249,W00008249,Output Areas and Small Areas,OASA,265,8,257
290878,W00008250,W00008250,Output Areas and Small Areas,OASA,231,8,223
290879,W00008251,W00008251,Output Areas and Small Areas,OASA,253,10,243
290880,W00008252,W00008252,Output Areas and Small Areas,OASA,240,13,227
290881,W00008253,W00008253,Output Areas and Small Areas,OASA,299,7,292
290882,W00008254,W00008254,Output Areas and Small Areas,OASA,266,7,259
290883,W00008255,W00008255,Output Areas and Small Areas,OASA,272,15,257
290884,W00008256,W00008256,Output Areas and Small Areas,OASA,245,11,234
290885,W00008257,W00008257,Output Areas and Small Areas,OASA,272,10,262
290886,W00008258,W00008258,Output Areas and Small Areas,OASA,269,8,261
290887,W00008260,W00008260,Output Areas and Small Areas,OASA,225,9,216
290888,W00008261,W00008261,Output Areas and Small Areas,OASA,284,5,279
290889,W00008262,W00008262,Output Areas and Small Areas,OASA,174,5,169
290890,W00008263,W00008263,Output Areas and Small Areas,OASA,246,9,237
290891,W00008264,W00008264,Output Areas and Small Areas,OASA,233,9,224
290892,W00008265,W00008265,Output Areas and Small Areas,OASA,211,3,208
290893,W00008266,W00008266,Output Areas and Small Areas,OASA,177,1,176
290894,W00008267,W00008267,Output Areas and Small Areas,OASA,270,14,256
290895,W00008268,W00008268,Output Areas and Small Areas,OASA,239,13,226
290896,W00008269,W00008269,Output Areas and Small Areas,OASA,242,11,231
290897,W00008270,W00008270,Output Areas and Small Areas,OASA,274,16,258
290898,W00008271,W00008271,Output Areas and Small Areas,OASA,230,13,217
290899,W00008272,W00008272,Output Areas and Small Areas,OASA,264,24,240
290900,W00008273,W00008273,Output Areas and Small Areas,OASA,222,9,213
290901,W00008274,W00008274,Output Areas and Small Areas,OASA,217,10,207
290902,W00008275,W00008275,Output Areas and Small Areas,OASA,234,12,222
290903,W00008276,W00008276,Output Areas and Small Areas,OASA,243,5,238
290904,W00008277,W00008277,Output Areas and Small Areas,OASA,281,10,271
290905,W00008278,W00008278,Output Areas and Small Areas,OASA,365,12,353
290906,W00008279,W00008279,Output Areas and Small Areas,OASA,297,20,277
290907,W00008280,W00008280,Output Areas and Small Areas,OASA,223,17,206
290908,W00008281,W00008281,Output Areas and Small Areas,OASA,318,17,301
290909,W00008282,W00008282,Output Areas and Small Areas,OASA,228,9,219
290910,W00008283,W00008283,Output Areas and Small Areas,OASA,393,8,385
290911,W00008284,W00008284,Output Areas and Small Areas,OASA,363,22,341
290912,W00008285,W00008285,Output Areas and Small Areas,OASA,302,14,288
290913,W00008286,W00008286,Output Areas and Small Areas,OASA,254,13,241
290914,W00008287,W00008287,Output Areas and Small Areas,OASA,276,15,261
290915,W00008288,W00008288,Output Areas and Small Areas,OASA,246,8,238
290916,W00008289,W00008289,Output Areas and Small Areas,OASA,238,4,234
290917,W00008290,W00008290,Output Areas and Small Areas,OASA,210,6,204
290918,W00008291,W00008291,Output Areas and Small Areas,OASA,246,11,235
290919,W00008292,W00008292,Output Areas and Small Areas,OASA,207,11,196
290920,W00008293,W00008293,Output Areas and Small Areas,OASA,216,15,201
290921,W00008294,W00008294,Output Areas and Small Areas,OASA,247,13,234
290922,W00008295,W00008295,Output Areas and Small Areas,OASA,223,8,215
290923,W00008296,W00008296,Output Areas and Small Areas,OASA,230,16,214
290924,W00008297,W00008297,Output Areas and Small Areas,OASA,247,10,237
290925,W00008298,W00008298,Output Areas and Small Areas,OASA,348,16,332
290926,W00008299,W00008299,Output Areas and Small Areas,OASA,291,16,275
290927,W00008300,W00008300,Output Areas and Small Areas,OASA,201,7,194
290928,W00008301,W00008301,Output Areas and Small Areas,OASA,311,8,303
290929,W00008302,W00008302,Output Areas and Small Areas,OASA,248,9,239
290930,W00008303,W00008303,Output Areas and Small Areas,OASA,350,15,335
290931,W00008304,W00008304,Output Areas and Small Areas,OASA,295,10,285
290932,W00008305,W00008305,Output Areas and Small Areas,OASA,283,11,272
290933,W00008306,W00008306,Output Areas and Small Areas,OASA,283,15,268
290934,W00008307,W00008307,Output Areas and Small Areas,OASA,230,6,224
290935,W00008308,W00008308,Output Areas and Small Areas,OASA,278,22,256
290936,W00008309,W00008309,Output Areas and Small Areas,OASA,239,9,230
290937,W00008311,W00008311,Output Areas and Small Areas,OASA,186,9,177
290938,W00008313,W00008313,Output Areas and Small Areas,OASA,221,17,204
290939,W00008314,W00008314,Output Areas and Small Areas,OASA,152,6,146
290940,W00008315,W00008315,Output Areas and Small Areas,OASA,269,13,256
290941,W00008316,W00008316,Output Areas and Small Areas,OASA,286,23,263
290942,W00008317,W00008317,Output Areas and Small Areas,OASA,239,7,232
290943,W00008318,W00008318,Output Areas and Small Areas,OASA,288,6,282
290944,W00008319,W00008319,Output Areas and Small Areas,OASA,270,8,262
290945,W00008320,W00008320,Output Areas and Small Areas,OASA,213,3,210
290946,W00008321,W00008321,Output Areas and Small Areas,OASA,242,13,229
290947,W00008322,W00008322,Output Areas and Small Areas,OASA,267,10,257
290948,W00008323,W00008323,Output Areas and Small Areas,OASA,210,6,204
290949,W00008324,W00008324,Output Areas and Small Areas,OASA,187,6,181
290950,W00008325,W00008325,Output Areas and Small Areas,OASA,153,7,146
290951,W00008326,W00008326,Output Areas and Small Areas,OASA,232,12,220
290952,W00008327,W00008327,Output Areas and Small Areas,OASA,260,11,249
290953,W00008328,W00008328,Output Areas and Small Areas,OASA,203,12,191
290954,W00008329,W00008329,Output Areas and Small Areas,OASA,255,14,241
290955,W00008330,W00008330,Output Areas and Small Areas,OASA,207,8,199
290956,W00008331,W00008331,Output Areas and Small Areas,OASA,206,9,197
290957,W00008332,W00008332,Output Areas and Small Areas,OASA,249,9,240
290958,W00008333,W00008333,Output Areas and Small Areas,OASA,228,23,205
290959,W00008334,W00008334,Output Areas and Small Areas,OASA,193,11,182
290960,W00008335,W00008335,Output Areas and Small Areas,OASA,246,12,234
290961,W00008336,W00008336,Output Areas and Small Areas,OASA,304,19,285
290962,W00008337,W00008337,Output Areas and Small Areas,OASA,253,17,236
290963,W00008338,W00008338,Output Areas and Small Areas,OASA,236,11,225
290964,W00008339,W00008339,Output Areas and Small Areas,OASA,222,11,211
290965,W00008340,W00008340,Output Areas and Small Areas,OASA,226,10,216
290966,W00008341,W00008341,Output Areas and Small Areas,OASA,188,9,179
290967,W00008342,W00008342,Output Areas and Small Areas,OASA,228,7,221
290968,W00008343,W00008343,Output Areas and Small Areas,OASA,254,7,247
290969,W00008344,W00008344,Output Areas and Small Areas,OASA,274,7,267
290970,W00008345,W00008345,Output Areas and Small Areas,OASA,281,14,267
290971,W00008346,W00008346,Output Areas and Small Areas,OASA,291,10,281
290972,W00008347,W00008347,Output Areas and Small Areas,OASA,229,6,223
290973,W00008348,W00008348,Output Areas and Small Areas,OASA,272,18,254
290974,W00008349,W00008349,Output Areas and Small Areas,OASA,314,12,302
290975,W00008350,W00008350,Output Areas and Small Areas,OASA,257,22,235
290976,W00008351,W00008351,Output Areas and Small Areas,OASA,298,12,286
290977,W00008352,W00008352,Output Areas and Small Areas,OASA,260,16,244
290978,W00008353,W00008353,Output Areas and Small Areas,OASA,226,18,208
290979,W00008354,W00008354,Output Areas and Small Areas,OASA,252,15,237
290980,W00008355,W00008355,Output Areas and Small Areas,OASA,293,10,283
290981,W00008356,W00008356,Output Areas and Small Areas,OASA,262,11,251
290982,W00008357,W00008357,Output Areas and Small Areas,OASA,228,7,221
290983,W00008358,W00008358,Output Areas and Small Areas,OASA,263,12,251
290984,W00008359,W00008359,Output Areas and Small Areas,OASA,216,10,206
290985,W00008360,W00008360,Output Areas and Small Areas,OASA,248,10,238
290986,W00008361,W00008361,Output Areas and Small Areas,OASA,272,11,261
290987,W00008362,W00008362,Output Areas and Small Areas,OASA,267,13,254
290988,W00008363,W00008363,Output Areas and Small Areas,OASA,290,11,279
290989,W00008364,W00008364,Output Areas and Small Areas,OASA,307,12,295
290990,W00008365,W00008365,Output Areas and Small Areas,OASA,133,7,126
290991,W00008366,W00008366,Output Areas and Small Areas,OASA,225,15,210
290992,W00008367,W00008367,Output Areas and Small Areas,OASA,180,6,174
290993,W00008368,W00008368,Output Areas and Small Areas,OASA,271,8,263
290994,W00008369,W00008369,Output Areas and Small Areas,OASA,210,0,210
290995,W00008370,W00008370,Output Areas and Small Areas,OASA,286,7,279
290996,W00008371,W00008371,Output Areas and Small Areas,OASA,247,7,240
290997,W00008372,W00008372,Output Areas and Small Areas,OASA,278,12,266
290998,W00008373,W00008373,Output Areas and Small Areas,OASA,233,8,225
290999,W00008374,W00008374,Output Areas and Small Areas,OASA,238,8,230
291000,W00008375,W00008375,Output Areas and Small Areas,OASA,248,14,234
291001,W00008376,W00008376,Output Areas and Small Areas,OASA,269,6,263
291002,W00008377,W00008377,Output Areas and Small Areas,OASA,208,15,193
291003,W00008378,W00008378,Output Areas and Small Areas,OASA,208,12,196
291004,W00008379,W00008379,Output Areas and Small Areas,OASA,233,14,219
291005,W00008380,W00008380,Output Areas and Small Areas,OASA,289,20,269
291006,W00008381,W00008381,Output Areas and Small Areas,OASA,251,10,241
291007,W00008382,W00008382,Output Areas and Small Areas,OASA,267,14,253
291008,W00008383,W00008383,Output Areas and Small Areas,OASA,243,8,235
291009,W00008384,W00008384,Output Areas and Small Areas,OASA,295,17,278
291010,W00008385,W00008385,Output Areas and Small Areas,OASA,200,4,196
291011,W00008386,W00008386,Output Areas and Small Areas,OASA,217,12,205
291012,W00008387,W00008387,Output Areas and Small Areas,OASA,207,7,200
291013,W00008388,W00008388,Output Areas and Small Areas,OASA,235,8,227
291014,W00008389,W00008389,Output Areas and Small Areas,OASA,191,4,187
291015,W00008390,W00008390,Output Areas and Small Areas,OASA,177,6,171
291016,W00008391,W00008391,Output Areas and Small Areas,OASA,264,14,250
291017,W00008392,W00008392,Output Areas and Small Areas,OASA,172,8,164
291018,W00008393,W00008393,Output Areas and Small Areas,OASA,268,13,255
291019,W00008394,W00008394,Output Areas and Small Areas,OASA,256,8,248
291020,W00008395,W00008395,Output Areas and Small Areas,OASA,261,10,251
291021,W00008396,W00008396,Output Areas and Small Areas,OASA,258,16,242
291022,W00008397,W00008397,Output Areas and Small Areas,OASA,261,12,249
291023,W00008398,W00008398,Output Areas and Small Areas,OASA,253,9,244
291024,W00008399,W00008399,Output Areas and Small Areas,OASA,271,8,263
291025,W00008400,W00008400,Output Areas and Small Areas,OASA,242,10,232
291026,W00008401,W00008401,Output Areas and Small Areas,OASA,253,13,240
291027,W00008402,W00008402,Output Areas and Small Areas,OASA,252,10,242
291028,W00008403,W00008403,Output Areas and Small Areas,OASA,243,6,237
291029,W00008404,W00008404,Output Areas and Small Areas,OASA,200,7,193
291030,W00008405,W00008405,Output Areas and Small Areas,OASA,248,9,239
291031,W00008406,W00008406,Output Areas and Small Areas,OASA,191,7,184
291032,W00008407,W00008407,Output Areas and Small Areas,OASA,267,16,251
291033,W00008408,W00008408,Output Areas and Small Areas,OASA,219,8,211
291034,W00008409,W00008409,Output Areas and Small Areas,OASA,290,12,278
291035,W00008410,W00008410,Output Areas and Small Areas,OASA,211,6,205
291036,W00008411,W00008411,Output Areas and Small Areas,OASA,205,15,190
291037,W00008412,W00008412,Output Areas and Small Areas,OASA,201,1,200
291038,W00008413,W00008413,Output Areas and Small Areas,OASA,168,2,166
291039,W00008414,W00008414,Output Areas and Small Areas,OASA,211,5,206
291040,W00008415,W00008415,Output Areas and Small Areas,OASA,218,4,214
291041,W00008416,W00008416,Output Areas and Small Areas,OASA,204,8,196
291042,W00008417,W00008417,Output Areas and Small Areas,OASA,200,7,193
291043,W00008418,W00008418,Output Areas and Small Areas,OASA,213,10,203
291044,W00008419,W00008419,Output Areas and Small Areas,OASA,201,3,198
291045,W00008420,W00008420,Output Areas and Small Areas,OASA,247,7,240
291046,W00008421,W00008421,Output Areas and Small Areas,OASA,186,6,180
291047,W00008422,W00008422,Output Areas and Small Areas,OASA,246,8,238
291048,W00008423,W00008423,Output Areas and Small Areas,OASA,200,7,193
291049,W00008424,W00008424,Output Areas and Small Areas,OASA,260,8,252
291050,W00008425,W00008425,Output Areas and Small Areas,OASA,234,0,234
291051,W00008426,W00008426,Output Areas and Small Areas,OASA,212,7,205
291052,W00008427,W00008427,Output Areas and Small Areas,OASA,224,5,219
291053,W00008428,W00008428,Output Areas and Small Areas,OASA,226,9,217
291054,W00008429,W00008429,Output Areas and Small Areas,OASA,228,10,218
291055,W00008430,W00008430,Output Areas and Small Areas,OASA,277,9,268
291056,W00008431,W00008431,Output Areas and Small Areas,OASA,244,7,237
291057,W00008432,W00008432,Output Areas and Small Areas,OASA,235,2,233
291058,W00008433,W00008433,Output Areas and Small Areas,OASA,224,2,222
291059,W00008434,W00008434,Output Areas and Small Areas,OASA,242,5,237
291060,W00008435,W00008435,Output Areas and Small Areas,OASA,228,8,220
291061,W00008436,W00008436,Output Areas and Small Areas,OASA,271,18,253
291062,W00008437,W00008437,Output Areas and Small Areas,OASA,303,13,290
291063,W00008438,W00008438,Output Areas and Small Areas,OASA,235,9,226
291064,W00008439,W00008439,Output Areas and Small Areas,OASA,406,28,378
291065,W00008440,W00008440,Output Areas and Small Areas,OASA,239,10,229
291066,W00008441,W00008441,Output Areas and Small Areas,OASA,223,12,211
291067,W00008442,W00008442,Output Areas and Small Areas,OASA,247,11,236
291068,W00008443,W00008443,Output Areas and Small Areas,OASA,326,19,307
291069,W00008444,W00008444,Output Areas and Small Areas,OASA,321,18,303
291070,W00008445,W00008445,Output Areas and Small Areas,OASA,202,16,186
291071,W00008446,W00008446,Output Areas and Small Areas,OASA,246,19,227
291072,W00008447,W00008447,Output Areas and Small Areas,OASA,271,9,262
291073,W00008448,W00008448,Output Areas and Small Areas,OASA,243,15,228
291074,W00008449,W00008449,Output Areas and Small Areas,OASA,228,12,216
291075,W00008450,W00008450,Output Areas and Small Areas,OASA,127,6,121
291076,W00008451,W00008451,Output Areas and Small Areas,OASA,233,14,219
291077,W00008452,W00008452,Output Areas and Small Areas,OASA,255,10,245
291078,W00008453,W00008453,Output Areas and Small Areas,OASA,249,11,238
291079,W00008454,W00008454,Output Areas and Small Areas,OASA,227,10,217
291080,W00008455,W00008455,Output Areas and Small Areas,OASA,232,12,220
291081,W00008456,W00008456,Output Areas and Small Areas,OASA,266,13,253
291082,W00008457,W00008457,Output Areas and Small Areas,OASA,224,7,217
291083,W00008458,W00008458,Output Areas and Small Areas,OASA,216,12,204
291084,W00008459,W00008459,Output Areas and Small Areas,OASA,262,13,249
291085,W00008460,W00008460,Output Areas and Small Areas,OASA,169,8,161
291086,W00008461,W00008461,Output Areas and Small Areas,OASA,195,18,177
291087,W00008462,W00008462,Output Areas and Small Areas,OASA,299,7,292
291088,W00008463,W00008463,Output Areas and Small Areas,OASA,325,13,312
291089,W00008464,W00008464,Output Areas and Small Areas,OASA,232,7,225
291090,W00008465,W00008465,Output Areas and Small Areas,OASA,237,6,231
291091,W00008466,W00008466,Output Areas and Small Areas,OASA,269,5,264
291092,W00008467,W00008467,Output Areas and Small Areas,OASA,258,10,248
291093,W00008468,W00008468,Output Areas and Small Areas,OASA,135,3,132
291094,W00008469,W00008469,Output Areas and Small Areas,OASA,241,4,237
291095,W00008470,W00008470,Output Areas and Small Areas,OASA,231,8,223
291096,W00008471,W00008471,Output Areas and Small Areas,OASA,252,16,236
291097,W00008472,W00008472,Output Areas and Small Areas,OASA,243,9,234
291098,W00008473,W00008473,Output Areas and Small Areas,OASA,199,6,193
291099,W00008474,W00008474,Output Areas and Small Areas,OASA,220,13,207
291100,W00008475,W00008475,Output Areas and Small Areas,OASA,235,10,225
291101,W00008476,W00008476,Output Areas and Small Areas,OASA,233,7,226
291102,W00008477,W00008477,Output Areas and Small Areas,OASA,215,2,213
291103,W00008478,W00008478,Output Areas and Small Areas,OASA,240,10,230
291104,W00008479,W00008479,Output Areas and Small Areas,OASA,195,5,190
291105,W00008480,W00008480,Output Areas and Small Areas,OASA,223,13,210
291106,W00008481,W00008481,Output Areas and Small Areas,OASA,287,13,274
291107,W00008482,W00008482,Output Areas and Small Areas,OASA,293,14,279
291108,W00008483,W00008483,Output Areas and Small Areas,OASA,234,4,230
291109,W00008484,W00008484,Output Areas and Small Areas,OASA,237,6,231
291110,W00008485,W00008485,Output Areas and Small Areas,OASA,251,9,242
291111,W00008486,W00008486,Output Areas and Small Areas,OASA,211,10,201
291112,W00008487,W00008487,Output Areas and Small Areas,OASA,228,8,220
291113,W00008488,W00008488,Output Areas and Small Areas,OASA,215,8,207
291114,W00008489,W00008489,Output Areas and Small Areas,OASA,229,6,223
291115,W00008490,W00008490,Output Areas and Small Areas,OASA,219,11,208
291116,W00008491,W00008491,Output Areas and Small Areas,OASA,269,6,263
291117,W00008492,W00008492,Output Areas and Small Areas,OASA,140,4,136
291118,W00008493,W00008493,Output Areas and Small Areas,OASA,224,9,215
291119,W00008494,W00008494,Output Areas and Small Areas,OASA,154,5,149
291120,W00008495,W00008495,Output Areas and Small Areas,OASA,241,12,229
291121,W00008496,W00008496,Output Areas and Small Areas,OASA,226,13,213
291122,W00008497,W00008497,Output Areas and Small Areas,OASA,240,10,230
291123,W00008499,W00008499,Output Areas and Small Areas,OASA,229,17,212
291124,W00008500,W00008500,Output Areas and Small Areas,OASA,244,17,227
291125,W00008501,W00008501,Output Areas and Small Areas,OASA,259,13,246
291126,W00008502,W00008502,Output Areas and Small Areas,OASA,354,28,326
291127,W00008503,W00008503,Output Areas and Small Areas,OASA,230,9,221
291128,W00008504,W00008504,Output Areas and Small Areas,OASA,209,10,199
291129,W00008505,W00008505,Output Areas and Small Areas,OASA,269,15,254
291130,W00008506,W00008506,Output Areas and Small Areas,OASA,246,15,231
291131,W00008507,W00008507,Output Areas and Small Areas,OASA,222,10,212
291132,W00008508,W00008508,Output Areas and Small Areas,OASA,185,8,177
291133,W00008509,W00008509,Output Areas and Small Areas,OASA,260,12,248
291134,W00008510,W00008510,Output Areas and Small Areas,OASA,270,19,251
291135,W00008511,W00008511,Output Areas and Small Areas,OASA,294,10,284
291136,W00008512,W00008512,Output Areas and Small Areas,OASA,319,18,301
291137,W00008513,W00008513,Output Areas and Small Areas,OASA,118,4,114
291138,W00008514,W00008514,Output Areas and Small Areas,OASA,478,17,461
291139,W00008515,W00008515,Output Areas and Small Areas,OASA,321,15,306
291140,W00008516,W00008516,Output Areas and Small Areas,OASA,234,9,225
291141,W00008517,W00008517,Output Areas and Small Areas,OASA,313,16,297
291142,W00008518,W00008518,Output Areas and Small Areas,OASA,322,17,305
291143,W00008519,W00008519,Output Areas and Small Areas,OASA,224,15,209
291144,W00008520,W00008520,Output Areas and Small Areas,OASA,336,13,323
291145,W00008521,W00008521,Output Areas and Small Areas,OASA,251,8,243
291146,W00008522,W00008522,Output Areas and Small Areas,OASA,197,5,192
291147,W00008523,W00008523,Output Areas and Small Areas,OASA,214,12,202
291148,W00008524,W00008524,Output Areas and Small Areas,OASA,225,7,218
291149,W00008525,W00008525,Output Areas and Small Areas,OASA,210,5,205
291150,W00008526,W00008526,Output Areas and Small Areas,OASA,248,10,238
291151,W00008527,W00008527,Output Areas and Small Areas,OASA,223,6,217
291152,W00008529,W00008529,Output Areas and Small Areas,OASA,245,9,236
291153,W00008530,W00008530,Output Areas and Small Areas,OASA,175,6,169
291154,W00008531,W00008531,Output Areas and Small Areas,OASA,221,5,216
291155,W00008532,W00008532,Output Areas and Small Areas,OASA,218,5,213
291156,W00008534,W00008534,Output Areas and Small Areas,OASA,201,8,193
291157,W00008535,W00008535,Output Areas and Small Areas,OASA,242,12,230
291158,W00008536,W00008536,Output Areas and Small Areas,OASA,273,9,264
291159,W00008537,W00008537,Output Areas and Small Areas,OASA,217,9,208
291160,W00008538,W00008538,Output Areas and Small Areas,OASA,255,10,245
291161,W00008539,W00008539,Output Areas and Small Areas,OASA,245,8,237
291162,W00008540,W00008540,Output Areas and Small Areas,OASA,297,8,289
291163,W00008541,W00008541,Output Areas and Small Areas,OASA,261,8,253
291164,W00008542,W00008542,Output Areas and Small Areas,OASA,202,4,198
291165,W00008543,W00008543,Output Areas and Small Areas,OASA,184,8,176
291166,W00008544,W00008544,Output Areas and Small Areas,OASA,218,4,214
291167,W00008545,W00008545,Output Areas and Small Areas,OASA,216,8,208
291168,W00008546,W00008546,Output Areas and Small Areas,OASA,213,8,205
291169,W00008547,W00008547,Output Areas and Small Areas,OASA,233,14,219
291170,W00008548,W00008548,Output Areas and Small Areas,OASA,255,10,245
291171,W00008549,W00008549,Output Areas and Small Areas,OASA,227,4,223
291172,W00008550,W00008550,Output Areas and Small Areas,OASA,245,11,234
291173,W00008551,W00008551,Output Areas and Small Areas,OASA,245,12,233
291174,W00008552,W00008552,Output Areas and Small Areas,OASA,238,6,232
291175,W00008553,W00008553,Output Areas and Small Areas,OASA,273,7,266
291176,W00008554,W00008554,Output Areas and Small Areas,OASA,216,10,206
291177,W00008555,W00008555,Output Areas and Small Areas,OASA,239,12,227
291178,W00008556,W00008556,Output Areas and Small Areas,OASA,453,28,425
291179,W00008557,W00008557,Output Areas and Small Areas,OASA,234,3,231
291180,W00008558,W00008558,Output Areas and Small Areas,OASA,249,7,242
291181,W00008559,W00008559,Output Areas and Small Areas,OASA,160,2,158
291182,W00008560,W00008560,Output Areas and Small Areas,OASA,235,9,226
291183,W00008561,W00008561,Output Areas and Small Areas,OASA,241,11,230
291184,W00008562,W00008562,Output Areas and Small Areas,OASA,222,7,215
291185,W00008563,W00008563,Output Areas and Small Areas,OASA,238,9,229
291186,W00008564,W00008564,Output Areas and Small Areas,OASA,137,5,132
291187,W00008565,W00008565,Output Areas and Small Areas,OASA,245,8,237
291188,W00008566,W00008566,Output Areas and Small Areas,OASA,220,15,205
291189,W00008567,W00008567,Output Areas and Small Areas,OASA,272,12,260
291190,W00008568,W00008568,Output Areas and Small Areas,OASA,251,7,244
291191,W00008569,W00008569,Output Areas and Small Areas,OASA,180,8,172
291192,W00008570,W00008570,Output Areas and Small Areas,OASA,256,17,239
291193,W00008571,W00008571,Output Areas and Small Areas,OASA,248,9,239
291194,W00008572,W00008572,Output Areas and Small Areas,OASA,238,4,234
291195,W00008573,W00008573,Output Areas and Small Areas,OASA,240,4,236
291196,W00008574,W00008574,Output Areas and Small Areas,OASA,301,10,291
291197,W00008575,W00008575,Output Areas and Small Areas,OASA,253,5,248
291198,W00008576,W00008576,Output Areas and Small Areas,OASA,263,7,256
291199,W00008577,W00008577,Output Areas and Small Areas,OASA,243,12,231
291200,W00008578,W00008578,Output Areas and Small Areas,OASA,322,9,313
291201,W00008579,W00008579,Output Areas and Small Areas,OASA,270,9,261
291202,W00008580,W00008580,Output Areas and Small Areas,OASA,249,9,240
291203,W00008581,W00008581,Output Areas and Small Areas,OASA,276,6,270
291204,W00008582,W00008582,Output Areas and Small Areas,OASA,253,7,246
291205,W00008583,W00008583,Output Areas and Small Areas,OASA,249,8,241
291206,W00008584,W00008584,Output Areas and Small Areas,OASA,177,4,173
291207,W00008585,W00008585,Output Areas and Small Areas,OASA,256,10,246
291208,W00008586,W00008586,Output Areas and Small Areas,OASA,278,19,259
291209,W00008587,W00008587,Output Areas and Small Areas,OASA,237,9,228
291210,W00008588,W00008588,Output Areas and Small Areas,OASA,246,12,234
291211,W00008589,W00008589,Output Areas and Small Areas,OASA,280,9,271
291212,W00008590,W00008590,Output Areas and Small Areas,OASA,249,9,240
291213,W00008591,W00008591,Output Areas and Small Areas,OASA,158,4,154
291214,W00008592,W00008592,Output Areas and Small Areas,OASA,244,7,237
291215,W00008593,W00008593,Output Areas and Small Areas,OASA,252,16,236
291216,W00008594,W00008594,Output Areas and Small Areas,OASA,199,8,191
291217,W00008595,W00008595,Output Areas and Small Areas,OASA,291,13,278
291218,W00008599,W00008599,Output Areas and Small Areas,OASA,283,18,265
291219,W00008600,W00008600,Output Areas and Small Areas,OASA,284,16,268
291220,W00008601,W00008601,Output Areas and Small Areas,OASA,387,16,371
291221,W00008602,W00008602,Output Areas and Small Areas,OASA,272,18,254
291222,W00008603,W00008603,Output Areas and Small Areas,OASA,330,13,317
291223,W00008604,W00008604,Output Areas and Small Areas,OASA,282,11,271
291224,W00008605,W00008605,Output Areas and Small Areas,OASA,256,10,246
291225,W00008606,W00008606,Output Areas and Small Areas,OASA,306,5,301
291226,W00008607,W00008607,Output Areas and Small Areas,OASA,354,13,341
291227,W00008608,W00008608,Output Areas and Small Areas,OASA,301,8,293
291228,W00008609,W00008609,Output Areas and Small Areas,OASA,274,2,272
291229,W00008610,W00008610,Output Areas and Small Areas,OASA,348,10,338
291230,W00008611,W00008611,Output Areas and Small Areas,OASA,246,13,233
291231,W00008612,W00008612,Output Areas and Small Areas,OASA,188,8,180
291232,W00008613,W00008613,Output Areas and Small Areas,OASA,251,13,238
291233,W00008614,W00008614,Output Areas and Small Areas,OASA,327,19,308
291234,W00008615,W00008615,Output Areas and Small Areas,OASA,310,10,300
291235,W00008616,W00008616,Output Areas and Small Areas,OASA,154,4,150
291236,W00008618,W00008618,Output Areas and Small Areas,OASA,181,5,176
291237,W00008619,W00008619,Output Areas and Small Areas,OASA,232,9,223
291238,W00008620,W00008620,Output Areas and Small Areas,OASA,253,16,237
291239,W00008621,W00008621,Output Areas and Small Areas,OASA,187,5,182
291240,W00008622,W00008622,Output Areas and Small Areas,OASA,293,7,286
291241,W00008623,W00008623,Output Areas and Small Areas,OASA,293,8,285
291242,W00008624,W00008624,Output Areas and Small Areas,OASA,318,6,312
291243,W00008626,W00008626,Output Areas and Small Areas,OASA,236,4,232
291244,W00008627,W00008627,Output Areas and Small Areas,OASA,249,10,239
291245,W00008628,W00008628,Output Areas and Small Areas,OASA,247,4,243
291246,W00008629,W00008629,Output Areas and Small Areas,OASA,258,4,254
291247,W00008630,W00008630,Output Areas and Small Areas,OASA,301,5,296
291248,W00008631,W00008631,Output Areas and Small Areas,OASA,251,6,245
291249,W00008632,W00008632,Output Areas and Small Areas,OASA,219,5,214
291250,W00008633,W00008633,Output Areas and Small Areas,OASA,241,10,231
291251,W00008634,W00008634,Output Areas and Small Areas,OASA,172,0,172
291252,W00008635,W00008635,Output Areas and Small Areas,OASA,255,6,249
291253,W00008636,W00008636,Output Areas and Small Areas,OASA,272,8,264
291254,W00008637,W00008637,Output Areas and Small Areas,OASA,240,13,227
291255,W00008638,W00008638,Output Areas and Small Areas,OASA,249,8,241
291256,W00008639,W00008639,Output Areas and Small Areas,OASA,242,10,232
291257,W00008640,W00008640,Output Areas and Small Areas,OASA,236,6,230
291258,W00008641,W00008641,Output Areas and Small Areas,OASA,228,9,219
291259,W00008642,W00008642,Output Areas and Small Areas,OASA,255,3,252
291260,W00008643,W00008643,Output Areas and Small Areas,OASA,230,12,218
291261,W00008644,W00008644,Output Areas and Small Areas,OASA,242,6,236
291262,W00008645,W00008645,Output Areas and Small Areas,OASA,261,9,252
291263,W00008646,W00008646,Output Areas and Small Areas,OASA,283,6,277
291264,W00008647,W00008647,Output Areas and Small Areas,OASA,164,2,162
291265,W00008648,W00008648,Output Areas and Small Areas,OASA,275,8,267
291266,W00008649,W00008649,Output Areas and Small Areas,OASA,332,12,320
291267,W00008650,W00008650,Output Areas and Small Areas,OASA,283,15,268
291268,W00008651,W00008651,Output Areas and Small Areas,OASA,214,3,211
291269,W00008652,W00008652,Output Areas and Small Areas,OASA,98,1,97
291270,W00008653,W00008653,Output Areas and Small Areas,OASA,217,4,213
291271,W00008654,W00008654,Output Areas and Small Areas,OASA,260,10,250
291272,W00008655,W00008655,Output Areas and Small Areas,OASA,245,15,230
291273,W00008656,W00008656,Output Areas and Small Areas,OASA,308,15,293
291274,W00008657,W00008657,Output Areas and Small Areas,OASA,210,7,203
291275,W00008658,W00008658,Output Areas and Small Areas,OASA,274,16,258
291276,W00008659,W00008659,Output Areas and Small Areas,OASA,230,8,222
291277,W00008660,W00008660,Output Areas and Small Areas,OASA,221,13,208
291278,W00008661,W00008661,Output Areas and Small Areas,OASA,197,10,187
291279,W00008662,W00008662,Output Areas and Small Areas,OASA,287,16,271
291280,W00008663,W00008663,Output Areas and Small Areas,OASA,202,11,191
291281,W00008665,W00008665,Output Areas and Small Areas,OASA,273,16,257
291282,W00008666,W00008666,Output Areas and Small Areas,OASA,218,12,206
291283,W00008667,W00008667,Output Areas and Small Areas,OASA,268,16,252
291284,W00008668,W00008668,Output Areas and Small Areas,OASA,211,11,200
291285,W00008669,W00008669,Output Areas and Small Areas,OASA,228,6,222
291286,W00008670,W00008670,Output Areas and Small Areas,OASA,252,4,248
291287,W00008671,W00008671,Output Areas and Small Areas,OASA,157,5,152
291288,W00008672,W00008672,Output Areas and Small Areas,OASA,187,7,180
291289,W00008673,W00008673,Output Areas and Small Areas,OASA,283,19,264
291290,W00008674,W00008674,Output Areas and Small Areas,OASA,246,14,232
291291,W00008675,W00008675,Output Areas and Small Areas,OASA,175,3,172
291292,W00008676,W00008676,Output Areas and Small Areas,OASA,375,14,361
291293,W00008678,W00008678,Output Areas and Small Areas,OASA,449,19,430
291294,W00008679,W00008679,Output Areas and Small Areas,OASA,323,15,308
291295,W00008680,W00008680,Output Areas and Small Areas,OASA,285,23,262
291296,W00008681,W00008681,Output Areas and Small Areas,OASA,258,16,242
291297,W00008682,W00008682,Output Areas and Small Areas,OASA,217,12,205
291298,W00008683,W00008683,Output Areas and Small Areas,OASA,226,10,216
291299,W00008684,W00008684,Output Areas and Small Areas,OASA,254,6,248
291300,W00008685,W00008685,Output Areas and Small Areas,OASA,246,7,239
291301,W00008686,W00008686,Output Areas and Small Areas,OASA,248,15,233
291302,W00008687,W00008687,Output Areas and Small Areas,OASA,251,12,239
291303,W00008688,W00008688,Output Areas and Small Areas,OASA,248,10,238
291304,W00008689,W00008689,Output Areas and Small Areas,OASA,252,5,247
291305,W00008690,W00008690,Output Areas and Small Areas,OASA,223,9,214
291306,W00008691,W00008691,Output Areas and Small Areas,OASA,204,11,193
291307,W00008692,W00008692,Output Areas and Small Areas,OASA,225,8,217
291308,W00008693,W00008693,Output Areas and Small Areas,OASA,208,10,198
291309,W00008694,W00008694,Output Areas and Small Areas,OASA,207,7,200
291310,W00008695,W00008695,Output Areas and Small Areas,OASA,287,18,269
291311,W00008696,W00008696,Output Areas and Small Areas,OASA,233,10,223
291312,W00008697,W00008697,Output Areas and Small Areas,OASA,217,10,207
291313,W00008698,W00008698,Output Areas and Small Areas,OASA,247,3,244
291314,W00008699,W00008699,Output Areas and Small Areas,OASA,184,15,169
291315,W00008700,W00008700,Output Areas and Small Areas,OASA,246,19,227
291316,W00008701,W00008701,Output Areas and Small Areas,OASA,280,12,268
291317,W00008702,W00008702,Output Areas and Small Areas,OASA,244,5,239
291318,W00008703,W00008703,Output Areas and Small Areas,OASA,229,5,224
291319,W00008704,W00008704,Output Areas and Small Areas,OASA,251,7,244
291320,W00008705,W00008705,Output Areas and Small Areas,OASA,270,10,260
291321,W00008706,W00008706,Output Areas and Small Areas,OASA,263,15,248
291322,W00008707,W00008707,Output Areas and Small Areas,OASA,240,16,224
291323,W00008708,W00008708,Output Areas and Small Areas,OASA,226,8,218
291324,W00008709,W00008709,Output Areas and Small Areas,OASA,237,9,228
291325,W00008710,W00008710,Output Areas and Small Areas,OASA,220,3,217
291326,W00008711,W00008711,Output Areas and Small Areas,OASA,262,15,247
291327,W00008712,W00008712,Output Areas and Small Areas,OASA,211,5,206
291328,W00008713,W00008713,Output Areas and Small Areas,OASA,285,18,267
291329,W00008714,W00008714,Output Areas and Small Areas,OASA,222,8,214
291330,W00008715,W00008715,Output Areas and Small Areas,OASA,235,4,231
291331,W00008716,W00008716,Output Areas and Small Areas,OASA,235,11,224
291332,W00008717,W00008717,Output Areas and Small Areas,OASA,236,7,229
291333,W00008718,W00008718,Output Areas and Small Areas,OASA,181,3,178
291334,W00008719,W00008719,Output Areas and Small Areas,OASA,208,8,200
291335,W00008720,W00008720,Output Areas and Small Areas,OASA,221,11,210
291336,W00008721,W00008721,Output Areas and Small Areas,OASA,231,8,223
291337,W00008722,W00008722,Output Areas and Small Areas,OASA,206,5,201
291338,W00008723,W00008723,Output Areas and Small Areas,OASA,227,6,221
291339,W00008724,W00008724,Output Areas and Small Areas,OASA,240,8,232
291340,W00008725,W00008725,Output Areas and Small Areas,OASA,215,6,209
291341,W00008726,W00008726,Output Areas and Small Areas,OASA,254,16,238
291342,W00008727,W00008727,Output Areas and Small Areas,OASA,195,7,188
291343,W00008728,W00008728,Output Areas and Small Areas,OASA,224,14,210
291344,W00008729,W00008729,Output Areas and Small Areas,OASA,211,15,196
291345,W00008730,W00008730,Output Areas and Small Areas,OASA,166,5,161
291346,W00008731,W00008731,Output Areas and Small Areas,OASA,236,8,228
291347,W00008732,W00008732,Output Areas and Small Areas,OASA,238,17,221
291348,W00008733,W00008733,Output Areas and Small Areas,OASA,302,10,292
291349,W00008734,W00008734,Output Areas and Small Areas,OASA,196,15,181
291350,W00008735,W00008735,Output Areas and Small Areas,OASA,236,14,222
291351,W00008736,W00008736,Output Areas and Small Areas,OASA,227,11,216
291352,W00008737,W00008737,Output Areas and Small Areas,OASA,269,15,254
291353,W00008738,W00008738,Output Areas and Small Areas,OASA,271,16,255
291354,W00008739,W00008739,Output Areas and Small Areas,OASA,208,10,198
291355,W00008740,W00008740,Output Areas and Small Areas,OASA,267,12,255
291356,W00008741,W00008741,Output Areas and Small Areas,OASA,267,4,263
291357,W00008742,W00008742,Output Areas and Small Areas,OASA,223,8,215
291358,W00008743,W00008743,Output Areas and Small Areas,OASA,264,10,254
291359,W00008744,W00008744,Output Areas and Small Areas,OASA,280,15,265
291360,W00008745,W00008745,Output Areas and Small Areas,OASA,184,7,177
291361,W00008746,W00008746,Output Areas and Small Areas,OASA,331,13,318
291362,W00008747,W00008747,Output Areas and Small Areas,OASA,188,9,179
291363,W00008749,W00008749,Output Areas and Small Areas,OASA,257,9,248
291364,W00008750,W00008750,Output Areas and Small Areas,OASA,207,9,198
291365,W00008751,W00008751,Output Areas and Small Areas,OASA,262,11,251
291366,W00008752,W00008752,Output Areas and Small Areas,OASA,147,2,145
291367,W00008753,W00008753,Output Areas and Small Areas,OASA,244,11,233
291368,W00008755,W00008755,Output Areas and Small Areas,OASA,154,0,154
291369,W00008757,W00008757,Output Areas and Small Areas,OASA,248,16,232
291370,W00008758,W00008758,Output Areas and Small Areas,OASA,195,7,188
291371,W00008759,W00008759,Output Areas and Small Areas,OASA,279,12,267
291372,W00008760,W00008760,Output Areas and Small Areas,OASA,282,9,273
291373,W00008761,W00008761,Output Areas and Small Areas,OASA,327,12,315
291374,W00008762,W00008762,Output Areas and Small Areas,OASA,315,19,296
291375,W00008763,W00008763,Output Areas and Small Areas,OASA,309,9,300
291376,W00008764,W00008764,Output Areas and Small Areas,OASA,332,9,323
291377,W00008765,W00008765,Output Areas and Small Areas,OASA,223,6,217
291378,W00008766,W00008766,Output Areas and Small Areas,OASA,383,15,368
291379,W00008767,W00008767,Output Areas and Small Areas,OASA,344,14,330
291380,W00008768,W00008768,Output Areas and Small Areas,OASA,254,13,241
291381,W00008769,W00008769,Output Areas and Small Areas,OASA,221,0,221
291382,W00008770,W00008770,Output Areas and Small Areas,OASA,228,11,217
291383,W00008771,W00008771,Output Areas and Small Areas,OASA,218,6,212
291384,W00008773,W00008773,Output Areas and Small Areas,OASA,252,3,249
291385,W00008774,W00008774,Output Areas and Small Areas,OASA,249,10,239
291386,W00008775,W00008775,Output Areas and Small Areas,OASA,198,13,185
291387,W00008776,W00008776,Output Areas and Small Areas,OASA,187,4,183
291388,W00008777,W00008777,Output Areas and Small Areas,OASA,283,9,274
291389,W00008778,W00008778,Output Areas and Small Areas,OASA,358,9,349
291390,W00008779,W00008779,Output Areas and Small Areas,OASA,276,10,266
291391,W00008780,W00008780,Output Areas and Small Areas,OASA,226,16,210
291392,W00008781,W00008781,Output Areas and Small Areas,OASA,372,18,354
291393,W00008782,W00008782,Output Areas and Small Areas,OASA,288,25,263
291394,W00008784,W00008784,Output Areas and Small Areas,OASA,309,15,294
291395,W00008785,W00008785,Output Areas and Small Areas,OASA,307,13,294
291396,W00008786,W00008786,Output Areas and Small Areas,OASA,257,19,238
291397,W00008788,W00008788,Output Areas and Small Areas,OASA,338,16,322
291398,W00008789,W00008789,Output Areas and Small Areas,OASA,244,10,234
291399,W00008790,W00008790,Output Areas and Small Areas,OASA,199,10,189
291400,W00008791,W00008791,Output Areas and Small Areas,OASA,185,8,177
291401,W00008792,W00008792,Output Areas and Small Areas,OASA,212,14,198
291402,W00008793,W00008793,Output Areas and Small Areas,OASA,304,11,293
291403,W00008794,W00008794,Output Areas and Small Areas,OASA,328,40,288
291404,W00008795,W00008795,Output Areas and Small Areas,OASA,341,17,324
291405,W00008797,W00008797,Output Areas and Small Areas,OASA,272,22,250
291406,W00008798,W00008798,Output Areas and Small Areas,OASA,329,26,303
291407,W00008799,W00008799,Output Areas and Small Areas,OASA,307,26,281
291408,W00008800,W00008800,Output Areas and Small Areas,OASA,292,19,273
291409,W00008801,W00008801,Output Areas and Small Areas,OASA,271,22,249
291410,W00008803,W00008803,Output Areas and Small Areas,OASA,232,8,224
291411,W00008804,W00008804,Output Areas and Small Areas,OASA,284,27,257
291412,W00008807,W00008807,Output Areas and Small Areas,OASA,394,27,367
291413,W00008808,W00008808,Output Areas and Small Areas,OASA,261,29,232
291414,W00008809,W00008809,Output Areas and Small Areas,OASA,264,14,250
291415,W00008811,W00008811,Output Areas and Small Areas,OASA,229,20,209
291416,W00008813,W00008813,Output Areas and Small Areas,OASA,250,27,223
291417,W00008814,W00008814,Output Areas and Small Areas,OASA,269,9,260
291418,W00008816,W00008816,Output Areas and Small Areas,OASA,236,7,229
291419,W00008817,W00008817,Output Areas and Small Areas,OASA,242,3,239
291420,W00008818,W00008818,Output Areas and Small Areas,OASA,370,11,359
291421,W00008819,W00008819,Output Areas and Small Areas,OASA,208,9,199
291422,W00008820,W00008820,Output Areas and Small Areas,OASA,376,23,353
291423,W00008821,W00008821,Output Areas and Small Areas,OASA,418,33,385
291424,W00008822,W00008822,Output Areas and Small Areas,OASA,244,9,235
291425,W00008823,W00008823,Output Areas and Small Areas,OASA,262,9,253
291426,W00008824,W00008824,Output Areas and Small Areas,OASA,330,10,320
291427,W00008825,W00008825,Output Areas and Small Areas,OASA,247,11,236
291428,W00008826,W00008826,Output Areas and Small Areas,OASA,276,17,259
291429,W00008827,W00008827,Output Areas and Small Areas,OASA,295,17,278
291430,W00008828,W00008828,Output Areas and Small Areas,OASA,233,20,213
291431,W00008829,W00008829,Output Areas and Small Areas,OASA,290,11,279
291432,W00008830,W00008830,Output Areas and Small Areas,OASA,257,11,246
291433,W00008831,W00008831,Output Areas and Small Areas,OASA,315,13,302
291434,W00008832,W00008832,Output Areas and Small Areas,OASA,218,7,211
291435,W00008833,W00008833,Output Areas and Small Areas,OASA,327,13,314
291436,W00008834,W00008834,Output Areas and Small Areas,OASA,195,6,189
291437,W00008835,W00008835,Output Areas and Small Areas,OASA,264,5,259
291438,W00008836,W00008836,Output Areas and Small Areas,OASA,191,8,183
291439,W00008837,W00008837,Output Areas and Small Areas,OASA,262,11,251
291440,W00008838,W00008838,Output Areas and Small Areas,OASA,210,10,200
291441,W00008839,W00008839,Output Areas and Small Areas,OASA,135,5,130
291442,W00008840,W00008840,Output Areas and Small Areas,OASA,235,12,223
291443,W00008841,W00008841,Output Areas and Small Areas,OASA,241,8,233
291444,W00008842,W00008842,Output Areas and Small Areas,OASA,260,21,239
291445,W00008843,W00008843,Output Areas and Small Areas,OASA,235,13,222
291446,W00008844,W00008844,Output Areas and Small Areas,OASA,229,12,217
291447,W00008845,W00008845,Output Areas and Small Areas,OASA,245,7,238
291448,W00008846,W00008846,Output Areas and Small Areas,OASA,172,15,157
291449,W00008847,W00008847,Output Areas and Small Areas,OASA,248,7,241
291450,W00008848,W00008848,Output Areas and Small Areas,OASA,228,17,211
291451,W00008849,W00008849,Output Areas and Small Areas,OASA,204,11,193
291452,W00008850,W00008850,Output Areas and Small Areas,OASA,272,18,254
291453,W00008851,W00008851,Output Areas and Small Areas,OASA,254,9,245
291454,W00008852,W00008852,Output Areas and Small Areas,OASA,181,6,175
291455,W00008853,W00008853,Output Areas and Small Areas,OASA,258,38,220
291456,W00008854,W00008854,Output Areas and Small Areas,OASA,240,35,205
291457,W00008855,W00008855,Output Areas and Small Areas,OASA,291,42,249
291458,W00008856,W00008856,Output Areas and Small Areas,OASA,244,50,194
291459,W00008857,W00008857,Output Areas and Small Areas,OASA,226,49,177
291460,W00008858,W00008858,Output Areas and Small Areas,OASA,212,34,178
291461,W00008859,W00008859,Output Areas and Small Areas,OASA,278,42,236
291462,W00008860,W00008860,Output Areas and Small Areas,OASA,250,55,195
291463,W00008861,W00008861,Output Areas and Small Areas,OASA,313,15,298
291464,W00008862,W00008862,Output Areas and Small Areas,OASA,211,35,176
291465,W00008863,W00008863,Output Areas and Small Areas,OASA,212,40,172
291466,W00008864,W00008864,Output Areas and Small Areas,OASA,240,49,191
291467,W00008865,W00008865,Output Areas and Small Areas,OASA,221,41,180
291468,W00008866,W00008866,Output Areas and Small Areas,OASA,254,57,197
291469,W00008867,W00008867,Output Areas and Small Areas,OASA,235,34,201
291470,W00008868,W00008868,Output Areas and Small Areas,OASA,258,52,206
291471,W00008869,W00008869,Output Areas and Small Areas,OASA,257,42,215
291472,W00008870,W00008870,Output Areas and Small Areas,OASA,254,26,228
291473,W00008871,W00008871,Output Areas and Small Areas,OASA,294,46,248
291474,W00008872,W00008872,Output Areas and Small Areas,OASA,243,28,215
291475,W00008873,W00008873,Output Areas and Small Areas,OASA,278,33,245
291476,W00008874,W00008874,Output Areas and Small Areas,OASA,287,45,242
291477,W00008875,W00008875,Output Areas and Small Areas,OASA,307,73,234
291478,W00008877,W00008877,Output Areas and Small Areas,OASA,285,34,251
291479,W00008878,W00008878,Output Areas and Small Areas,OASA,235,46,189
291480,W00008879,W00008879,Output Areas and Small Areas,OASA,256,57,199
291481,W00008880,W00008880,Output Areas and Small Areas,OASA,307,40,267
291482,W00008881,W00008881,Output Areas and Small Areas,OASA,249,29,220
291483,W00008882,W00008882,Output Areas and Small Areas,OASA,232,24,208
291484,W00008883,W00008883,Output Areas and Small Areas,OASA,248,15,233
291485,W00008884,W00008884,Output Areas and Small Areas,OASA,166,7,159
291486,W00008885,W00008885,Output Areas and Small Areas,OASA,339,16,323
291487,W00008886,W00008886,Output Areas and Small Areas,OASA,268,60,208
291488,W00008887,W00008887,Output Areas and Small Areas,OASA,277,69,208
291489,W00008888,W00008888,Output Areas and Small Areas,OASA,191,12,179
291490,W00008889,W00008889,Output Areas and Small Areas,OASA,245,48,197
291491,W00008890,W00008890,Output Areas and Small Areas,OASA,231,47,184
291492,W00008891,W00008891,Output Areas and Small Areas,OASA,190,19,171
291493,W00008892,W00008892,Output Areas and Small Areas,OASA,237,65,172
291494,W00008893,W00008893,Output Areas and Small Areas,OASA,279,34,245
291495,W00008894,W00008894,Output Areas and Small Areas,OASA,255,43,212
291496,W00008895,W00008895,Output Areas and Small Areas,OASA,218,34,184
291497,W00008896,W00008896,Output Areas and Small Areas,OASA,234,48,186
291498,W00008897,W00008897,Output Areas and Small Areas,OASA,167,28,139
291499,W00008899,W00008899,Output Areas and Small Areas,OASA,418,39,379
291500,W00008900,W00008900,Output Areas and Small Areas,OASA,515,43,472
291501,W00008901,W00008901,Output Areas and Small Areas,OASA,486,66,420
291502,W00008902,W00008902,Output Areas and Small Areas,OASA,550,52,498
291503,W00008903,W00008903,Output Areas and Small Areas,OASA,468,50,418
291504,W00008904,W00008904,Output Areas and Small Areas,OASA,452,39,413
291505,W00008906,W00008906,Output Areas and Small Areas,OASA,351,32,319
291506,W00008907,W00008907,Output Areas and Small Areas,OASA,576,63,513
291507,W00008909,W00008909,Output Areas and Small Areas,OASA,456,54,402
291508,W00008910,W00008910,Output Areas and Small Areas,OASA,568,69,499
291509,W00008911,W00008911,Output Areas and Small Areas,OASA,358,33,325
291510,W00008912,W00008912,Output Areas and Small Areas,OASA,520,46,474
291511,W00008913,W00008913,Output Areas and Small Areas,OASA,443,61,382
291512,W00008915,W00008915,Output Areas and Small Areas,OASA,449,46,403
291513,W00008916,W00008916,Output Areas and Small Areas,OASA,447,43,404
291514,W00008918,W00008918,Output Areas and Small Areas,OASA,410,54,356
291515,W00008919,W00008919,Output Areas and Small Areas,OASA,254,25,229
291516,W00008920,W00008920,Output Areas and Small Areas,OASA,411,53,358
291517,W00008921,W00008921,Output Areas and Small Areas,OASA,242,31,211
291518,W00008922,W00008922,Output Areas and Small Areas,OASA,503,41,462
291519,W00008923,W00008923,Output Areas and Small Areas,OASA,346,29,317
291520,W00008924,W00008924,Output Areas and Small Areas,OASA,463,34,429
291521,W00008925,W00008925,Output Areas and Small Areas,OASA,380,39,341
291522,W00008926,W00008926,Output Areas and Small Areas,OASA,345,31,314
291523,W00008927,W00008927,Output Areas and Small Areas,OASA,383,36,347
291524,W00008929,W00008929,Output Areas and Small Areas,OASA,342,35,307
291525,W00008930,W00008930,Output Areas and Small Areas,OASA,461,33,428
291526,W00008931,W00008931,Output Areas and Small Areas,OASA,381,33,348
291527,W00008932,W00008932,Output Areas and Small Areas,OASA,499,72,427
291528,W00008933,W00008933,Output Areas and Small Areas,OASA,336,44,292
291529,W00008934,W00008934,Output Areas and Small Areas,OASA,255,34,221
291530,W00008935,W00008935,Output Areas and Small Areas,OASA,210,35,175
291531,W00008936,W00008936,Output Areas and Small Areas,OASA,238,48,190
291532,W00008937,W00008937,Output Areas and Small Areas,OASA,252,46,206
291533,W00008938,W00008938,Output Areas and Small Areas,OASA,265,42,223
291534,W00008939,W00008939,Output Areas and Small Areas,OASA,217,37,180
291535,W00008940,W00008940,Output Areas and Small Areas,OASA,251,54,197
291536,W00008941,W00008941,Output Areas and Small Areas,OASA,236,26,210
291537,W00008942,W00008942,Output Areas and Small Areas,OASA,206,58,148
291538,W00008943,W00008943,Output Areas and Small Areas,OASA,390,36,354
291539,W00008945,W00008945,Output Areas and Small Areas,OASA,233,18,215
291540,W00008946,W00008946,Output Areas and Small Areas,OASA,338,30,308
291541,W00008947,W00008947,Output Areas and Small Areas,OASA,245,13,232
291542,W00008948,W00008948,Output Areas and Small Areas,OASA,263,30,233
291543,W00008949,W00008949,Output Areas and Small Areas,OASA,262,28,234
291544,W00008950,W00008950,Output Areas and Small Areas,OASA,286,16,270
291545,W00008951,W00008951,Output Areas and Small Areas,OASA,311,20,291
291546,W00008952,W00008952,Output Areas and Small Areas,OASA,258,28,230
291547,W00008953,W00008953,Output Areas and Small Areas,OASA,251,19,232
291548,W00008954,W00008954,Output Areas and Small Areas,OASA,263,15,248
291549,W00008955,W00008955,Output Areas and Small Areas,OASA,264,29,235
291550,W00008956,W00008956,Output Areas and Small Areas,OASA,254,15,239
291551,W00008957,W00008957,Output Areas and Small Areas,OASA,287,20,267
291552,W00008958,W00008958,Output Areas and Small Areas,OASA,240,25,215
291553,W00008959,W00008959,Output Areas and Small Areas,OASA,221,23,198
291554,W00008960,W00008960,Output Areas and Small Areas,OASA,284,26,258
291555,W00008961,W00008961,Output Areas and Small Areas,OASA,258,23,235
291556,W00008962,W00008962,Output Areas and Small Areas,OASA,231,18,213
291557,W00008963,W00008963,Output Areas and Small Areas,OASA,283,23,260
291558,W00008964,W00008964,Output Areas and Small Areas,OASA,263,12,251
291559,W00008965,W00008965,Output Areas and Small Areas,OASA,278,21,257
291560,W00008966,W00008966,Output Areas and Small Areas,OASA,241,27,214
291561,W00008967,W00008967,Output Areas and Small Areas,OASA,132,1,131
291562,W00008969,W00008969,Output Areas and Small Areas,OASA,204,8,196
291563,W00008970,W00008970,Output Areas and Small Areas,OASA,244,35,209
291564,W00008971,W00008971,Output Areas and Small Areas,OASA,258,22,236
291565,W00008972,W00008972,Output Areas and Small Areas,OASA,269,15,254
291566,W00008973,W00008973,Output Areas and Small Areas,OASA,286,29,257
291567,W00008974,W00008974,Output Areas and Small Areas,OASA,233,11,222
291568,W00008975,W00008975,Output Areas and Small Areas,OASA,215,35,180
291569,W00008976,W00008976,Output Areas and Small Areas,OASA,273,18,255
291570,W00008977,W00008977,Output Areas and Small Areas,OASA,264,39,225
291571,W00008978,W00008978,Output Areas and Small Areas,OASA,175,8,167
291572,W00008979,W00008979,Output Areas and Small Areas,OASA,219,16,203
291573,W00008980,W00008980,Output Areas and Small Areas,OASA,239,21,218
291574,W00008981,W00008981,Output Areas and Small Areas,OASA,254,12,242
291575,W00008982,W00008982,Output Areas and Small Areas,OASA,231,8,223
291576,W00008983,W00008983,Output Areas and Small Areas,OASA,252,27,225
291577,W00008984,W00008984,Output Areas and Small Areas,OASA,279,28,251
291578,W00008985,W00008985,Output Areas and Small Areas,OASA,247,7,240
291579,W00008986,W00008986,Output Areas and Small Areas,OASA,237,12,225
291580,W00008987,W00008987,Output Areas and Small Areas,OASA,234,9,225
291581,W00008988,W00008988,Output Areas and Small Areas,OASA,207,9,198
291582,W00008989,W00008989,Output Areas and Small Areas,OASA,291,15,276
291583,W00008990,W00008990,Output Areas and Small Areas,OASA,243,20,223
291584,W00008991,W00008991,Output Areas and Small Areas,OASA,269,10,259
291585,W00008992,W00008992,Output Areas and Small Areas,OASA,255,10,245
291586,W00008993,W00008993,Output Areas and Small Areas,OASA,293,7,286
291587,W00008994,W00008994,Output Areas and Small Areas,OASA,208,5,203
291588,W00008995,W00008995,Output Areas and Small Areas,OASA,253,11,242
291589,W00008996,W00008996,Output Areas and Small Areas,OASA,214,10,204
291590,W00008997,W00008997,Output Areas and Small Areas,OASA,210,9,201
291591,W00008998,W00008998,Output Areas and Small Areas,OASA,273,14,259
291592,W00008999,W00008999,Output Areas and Small Areas,OASA,250,18,232
291593,W00009000,W00009000,Output Areas and Small Areas,OASA,251,10,241
291594,W00009001,W00009001,Output Areas and Small Areas,OASA,217,5,212
291595,W00009002,W00009002,Output Areas and Small Areas,OASA,282,5,277
291596,W00009003,W00009003,Output Areas and Small Areas,OASA,251,9,242
291597,W00009004,W00009004,Output Areas and Small Areas,OASA,209,4,205
291598,W00009005,W00009005,Output Areas and Small Areas,OASA,255,17,238
291599,W00009006,W00009006,Output Areas and Small Areas,OASA,208,9,199
291600,W00009007,W00009007,Output Areas and Small Areas,OASA,195,12,183
291601,W00009008,W00009008,Output Areas and Small Areas,OASA,216,3,213
291602,W00009009,W00009009,Output Areas and Small Areas,OASA,244,12,232
291603,W00009010,W00009010,Output Areas and Small Areas,OASA,212,7,205
291604,W00009011,W00009011,Output Areas and Small Areas,OASA,208,13,195
291605,W00009012,W00009012,Output Areas and Small Areas,OASA,193,10,183
291606,W00009013,W00009013,Output Areas and Small Areas,OASA,260,9,251
291607,W00009014,W00009014,Output Areas and Small Areas,OASA,239,11,228
291608,W00009015,W00009015,Output Areas and Small Areas,OASA,275,22,253
291609,W00009016,W00009016,Output Areas and Small Areas,OASA,158,4,154
291610,W00009017,W00009017,Output Areas and Small Areas,OASA,223,5,218
291611,W00009018,W00009018,Output Areas and Small Areas,OASA,216,13,203
291612,W00009019,W00009019,Output Areas and Small Areas,OASA,195,9,186
291613,W00009020,W00009020,Output Areas and Small Areas,OASA,186,8,178
291614,W00009021,W00009021,Output Areas and Small Areas,OASA,243,11,232
291615,W00009022,W00009022,Output Areas and Small Areas,OASA,216,16,200
291616,W00009023,W00009023,Output Areas and Small Areas,OASA,192,10,182
291617,W00009024,W00009024,Output Areas and Small Areas,OASA,239,6,233
291618,W00009025,W00009025,Output Areas and Small Areas,OASA,176,11,165
291619,W00009026,W00009026,Output Areas and Small Areas,OASA,225,16,209
291620,W00009027,W00009027,Output Areas and Small Areas,OASA,228,7,221
291621,W00009028,W00009028,Output Areas and Small Areas,OASA,152,6,146
291622,W00009029,W00009029,Output Areas and Small Areas,OASA,209,5,204
291623,W00009030,W00009030,Output Areas and Small Areas,OASA,254,22,232
291624,W00009031,W00009031,Output Areas and Small Areas,OASA,256,14,242
291625,W00009032,W00009032,Output Areas and Small Areas,OASA,198,8,190
291626,W00009033,W00009033,Output Areas and Small Areas,OASA,246,14,232
291627,W00009034,W00009034,Output Areas and Small Areas,OASA,274,18,256
291628,W00009035,W00009035,Output Areas and Small Areas,OASA,278,18,260
291629,W00009036,W00009036,Output Areas and Small Areas,OASA,273,17,256
291630,W00009037,W00009037,Output Areas and Small Areas,OASA,239,7,232
291631,W00009038,W00009038,Output Areas and Small Areas,OASA,196,8,188
291632,W00009039,W00009039,Output Areas and Small Areas,OASA,233,21,212
291633,W00009040,W00009040,Output Areas and Small Areas,OASA,228,10,218
291634,W00009041,W00009041,Output Areas and Small Areas,OASA,216,10,206
291635,W00009042,W00009042,Output Areas and Small Areas,OASA,232,19,213
291636,W00009043,W00009043,Output Areas and Small Areas,OASA,313,19,294
291637,W00009044,W00009044,Output Areas and Small Areas,OASA,162,5,157
291638,W00009045,W00009045,Output Areas and Small Areas,OASA,245,9,236
291639,W00009046,W00009046,Output Areas and Small Areas,OASA,221,15,206
291640,W00009047,W00009047,Output Areas and Small Areas,OASA,206,9,197
291641,W00009048,W00009048,Output Areas and Small Areas,OASA,262,28,234
291642,W00009049,W00009049,Output Areas and Small Areas,OASA,224,13,211
291643,W00009050,W00009050,Output Areas and Small Areas,OASA,223,14,209
291644,W00009051,W00009051,Output Areas and Small Areas,OASA,277,25,252
291645,W00009052,W00009052,Output Areas and Small Areas,OASA,203,18,185
291646,W00009053,W00009053,Output Areas and Small Areas,OASA,179,11,168
291647,W00009054,W00009054,Output Areas and Small Areas,OASA,292,16,276
291648,W00009055,W00009055,Output Areas and Small Areas,OASA,295,21,274
291649,W00009056,W00009056,Output Areas and Small Areas,OASA,263,15,248
291650,W00009057,W00009057,Output Areas and Small Areas,OASA,251,18,233
291651,W00009058,W00009058,Output Areas and Small Areas,OASA,221,15,206
291652,W00009059,W00009059,Output Areas and Small Areas,OASA,254,12,242
291653,W00009060,W00009060,Output Areas and Small Areas,OASA,257,41,216
291654,W00009061,W00009061,Output Areas and Small Areas,OASA,243,27,216
291655,W00009062,W00009062,Output Areas and Small Areas,OASA,216,26,190
291656,W00009063,W00009063,Output Areas and Small Areas,OASA,202,15,187
291657,W00009064,W00009064,Output Areas and Small Areas,OASA,241,16,225
291658,W00009065,W00009065,Output Areas and Small Areas,OASA,268,18,250
291659,W00009066,W00009066,Output Areas and Small Areas,OASA,264,15,249
291660,W00009067,W00009067,Output Areas and Small Areas,OASA,230,17,213
291661,W00009068,W00009068,Output Areas and Small Areas,OASA,208,19,189
291662,W00009069,W00009069,Output Areas and Small Areas,OASA,268,17,251
291663,W00009070,W00009070,Output Areas and Small Areas,OASA,237,11,226
291664,W00009071,W00009071,Output Areas and Small Areas,OASA,215,9,206
291665,W00009072,W00009072,Output Areas and Small Areas,OASA,213,5,208
291666,W00009073,W00009073,Output Areas and Small Areas,OASA,309,13,296
291667,W00009074,W00009074,Output Areas and Small Areas,OASA,270,25,245
291668,W00009075,W00009075,Output Areas and Small Areas,OASA,329,47,282
291669,W00009077,W00009077,Output Areas and Small Areas,OASA,343,42,301
291670,W00009079,W00009079,Output Areas and Small Areas,OASA,399,17,382
291671,W00009080,W00009080,Output Areas and Small Areas,OASA,390,46,344
291672,W00009081,W00009081,Output Areas and Small Areas,OASA,275,35,240
291673,W00009082,W00009082,Output Areas and Small Areas,OASA,309,23,286
291674,W00009083,W00009083,Output Areas and Small Areas,OASA,578,74,504
291675,W00009084,W00009084,Output Areas and Small Areas,OASA,269,20,249
291676,W00009085,W00009085,Output Areas and Small Areas,OASA,353,37,316
291677,W00009086,W00009086,Output Areas and Small Areas,OASA,307,34,273
291678,W00009087,W00009087,Output Areas and Small Areas,OASA,329,33,296
291679,W00009088,W00009088,Output Areas and Small Areas,OASA,322,44,278
291680,W00009089,W00009089,Output Areas and Small Areas,OASA,321,35,286
291681,W00009090,W00009090,Output Areas and Small Areas,OASA,287,16,271
291682,W00009091,W00009091,Output Areas and Small Areas,OASA,255,15,240
291683,W00009092,W00009092,Output Areas and Small Areas,OASA,257,28,229
291684,W00009093,W00009093,Output Areas and Small Areas,OASA,313,28,285
291685,W00009094,W00009094,Output Areas and Small Areas,OASA,223,20,203
291686,W00009095,W00009095,Output Areas and Small Areas,OASA,264,14,250
291687,W00009096,W00009096,Output Areas and Small Areas,OASA,300,20,280
291688,W00009097,W00009097,Output Areas and Small Areas,OASA,253,23,230
291689,W00009098,W00009098,Output Areas and Small Areas,OASA,287,13,274
291690,W00009099,W00009099,Output Areas and Small Areas,OASA,236,25,211
291691,W00009100,W00009100,Output Areas and Small Areas,OASA,245,15,230
291692,W00009101,W00009101,Output Areas and Small Areas,OASA,317,14,303
291693,W00009102,W00009102,Output Areas and Small Areas,OASA,225,19,206
291694,W00009104,W00009104,Output Areas and Small Areas,OASA,295,22,273
291695,W00009105,W00009105,Output Areas and Small Areas,OASA,312,20,292
291696,W00009106,W00009106,Output Areas and Small Areas,OASA,246,26,220
291697,W00009107,W00009107,Output Areas and Small Areas,OASA,267,23,244
291698,W00009108,W00009108,Output Areas and Small Areas,OASA,227,26,201
291699,W00009109,W00009109,Output Areas and Small Areas,OASA,153,11,142
291700,W00009110,W00009110,Output Areas and Small Areas,OASA,309,36,273
291701,W00009111,W00009111,Output Areas and Small Areas,OASA,268,25,243
291702,W00009112,W00009112,Output Areas and Small Areas,OASA,320,26,294
291703,W00009113,W00009113,Output Areas and Small Areas,OASA,245,25,220
291704,W00009114,W00009114,Output Areas and Small Areas,OASA,399,21,378
291705,W00009115,W00009115,Output Areas and Small Areas,OASA,228,10,218
291706,W00009116,W00009116,Output Areas and Small Areas,OASA,244,27,217
291707,W00009117,W00009117,Output Areas and Small Areas,OASA,318,11,307
291708,W00009118,W00009118,Output Areas and Small Areas,OASA,238,14,224
291709,W00009119,W00009119,Output Areas and Small Areas,OASA,254,16,238
291710,W00009120,W00009120,Output Areas and Small Areas,OASA,268,17,251
291711,W00009121,W00009121,Output Areas and Small Areas,OASA,301,15,286
291712,W00009123,W00009123,Output Areas and Small Areas,OASA,327,27,300
291713,W00009125,W00009125,Output Areas and Small Areas,OASA,255,29,226
291714,W00009126,W00009126,Output Areas and Small Areas,OASA,326,31,295
291715,W00009127,W00009127,Output Areas and Small Areas,OASA,253,24,229
291716,W00009128,W00009128,Output Areas and Small Areas,OASA,311,14,297
291717,W00009129,W00009129,Output Areas and Small Areas,OASA,270,17,253
291718,W00009130,W00009130,Output Areas and Small Areas,OASA,230,36,194
291719,W00009131,W00009131,Output Areas and Small Areas,OASA,269,16,253
291720,W00009132,W00009132,Output Areas and Small Areas,OASA,253,11,242
291721,W00009133,W00009133,Output Areas and Small Areas,OASA,254,15,239
291722,W00009134,W00009134,Output Areas and Small Areas,OASA,228,26,202
291723,W00009135,W00009135,Output Areas and Small Areas,OASA,267,18,249
291724,W00009136,W00009136,Output Areas and Small Areas,OASA,260,26,234
291725,W00009137,W00009137,Output Areas and Small Areas,OASA,202,43,159
291726,W00009138,W00009138,Output Areas and Small Areas,OASA,282,39,243
291727,W00009139,W00009139,Output Areas and Small Areas,OASA,243,20,223
291728,W00009140,W00009140,Output Areas and Small Areas,OASA,301,25,276
291729,W00009141,W00009141,Output Areas and Small Areas,OASA,352,24,328
291730,W00009142,W00009142,Output Areas and Small Areas,OASA,185,7,178
291731,W00009143,W00009143,Output Areas and Small Areas,OASA,235,24,211
291732,W00009144,W00009144,Output Areas and Small Areas,OASA,214,22,192
291733,W00009145,W00009145,Output Areas and Small Areas,OASA,251,18,233
291734,W00009146,W00009146,Output Areas and Small Areas,OASA,299,46,253
291735,W00009147,W00009147,Output Areas and Small Areas,OASA,252,20,232
291736,W00009148,W00009148,Output Areas and Small Areas,OASA,116,8,108
291737,W00009149,W00009149,Output Areas and Small Areas,OASA,294,35,259
291738,W00009150,W00009150,Output Areas and Small Areas,OASA,291,23,268
291739,W00009151,W00009151,Output Areas and Small Areas,OASA,278,14,264
291740,W00009152,W00009152,Output Areas and Small Areas,OASA,289,19,270
291741,W00009153,W00009153,Output Areas and Small Areas,OASA,267,17,250
291742,W00009154,W00009154,Output Areas and Small Areas,OASA,410,34,376
291743,W00009155,W00009155,Output Areas and Small Areas,OASA,159,10,149
291744,W00009156,W00009156,Output Areas and Small Areas,OASA,229,26,203
291745,W00009157,W00009157,Output Areas and Small Areas,OASA,364,26,338
291746,W00009159,W00009159,Output Areas and Small Areas,OASA,304,20,284
291747,W00009160,W00009160,Output Areas and Small Areas,OASA,254,28,226
291748,W00009161,W00009161,Output Areas and Small Areas,OASA,335,26,309
291749,W00009162,W00009162,Output Areas and Small Areas,OASA,220,23,197
291750,W00009163,W00009163,Output Areas and Small Areas,OASA,246,36,210
291751,W00009164,W00009164,Output Areas and Small Areas,OASA,226,20,206
291752,W00009165,W00009165,Output Areas and Small Areas,OASA,213,22,191
291753,W00009166,W00009166,Output Areas and Small Areas,OASA,261,17,244
291754,W00009168,W00009168,Output Areas and Small Areas,OASA,233,18,215
291755,W00009169,W00009169,Output Areas and Small Areas,OASA,310,32,278
291756,W00009170,W00009170,Output Areas and Small Areas,OASA,253,25,228
291757,W00009171,W00009171,Output Areas and Small Areas,OASA,406,42,364
291758,W00009172,W00009172,Output Areas and Small Areas,OASA,264,22,242
291759,W00009173,W00009173,Output Areas and Small Areas,OASA,235,23,212
291760,W00009174,W00009174,Output Areas and Small Areas,OASA,280,25,255
291761,W00009175,W00009175,Output Areas and Small Areas,OASA,291,27,264
291762,W00009176,W00009176,Output Areas and Small Areas,OASA,329,30,299
291763,W00009177,W00009177,Output Areas and Small Areas,OASA,252,21,231
291764,W00009178,W00009178,Output Areas and Small Areas,OASA,221,18,203
291765,W00009179,W00009179,Output Areas and Small Areas,OASA,263,17,246
291766,W00009180,W00009180,Output Areas and Small Areas,OASA,255,13,242
291767,W00009181,W00009181,Output Areas and Small Areas,OASA,247,11,236
291768,W00009182,W00009182,Output Areas and Small Areas,OASA,276,20,256
291769,W00009183,W00009183,Output Areas and Small Areas,OASA,372,24,348
291770,W00009184,W00009184,Output Areas and Small Areas,OASA,259,20,239
291771,W00009186,W00009186,Output Areas and Small Areas,OASA,215,35,180
291772,W00009187,W00009187,Output Areas and Small Areas,OASA,214,30,184
291773,W00009188,W00009188,Output Areas and Small Areas,OASA,242,34,208
291774,W00009189,W00009189,Output Areas and Small Areas,OASA,251,19,232
291775,W00009190,W00009190,Output Areas and Small Areas,OASA,261,21,240
291776,W00009191,W00009191,Output Areas and Small Areas,OASA,422,32,390
291777,W00009192,W00009192,Output Areas and Small Areas,OASA,215,33,182
291778,W00009193,W00009193,Output Areas and Small Areas,OASA,198,24,174
291779,W00009194,W00009194,Output Areas and Small Areas,OASA,263,43,220
291780,W00009195,W00009195,Output Areas and Small Areas,OASA,249,35,214
291781,W00009196,W00009196,Output Areas and Small Areas,OASA,252,25,227
291782,W00009197,W00009197,Output Areas and Small Areas,OASA,312,46,266
291783,W00009198,W00009198,Output Areas and Small Areas,OASA,333,81,252
291784,W00009199,W00009199,Output Areas and Small Areas,OASA,232,32,200
291785,W00009200,W00009200,Output Areas and Small Areas,OASA,263,35,228
291786,W00009201,W00009201,Output Areas and Small Areas,OASA,247,17,230
291787,W00009202,W00009202,Output Areas and Small Areas,OASA,217,28,189
291788,W00009203,W00009203,Output Areas and Small Areas,OASA,195,31,164
291789,W00009204,W00009204,Output Areas and Small Areas,OASA,191,31,160
291790,W00009205,W00009205,Output Areas and Small Areas,OASA,274,31,243
291791,W00009206,W00009206,Output Areas and Small Areas,OASA,265,16,249
291792,W00009207,W00009207,Output Areas and Small Areas,OASA,216,19,197
291793,W00009208,W00009208,Output Areas and Small Areas,OASA,304,15,289
291794,W00009209,W00009209,Output Areas and Small Areas,OASA,228,17,211
291795,W00009210,W00009210,Output Areas and Small Areas,OASA,187,20,167
291796,W00009211,W00009211,Output Areas and Small Areas,OASA,238,22,216
291797,W00009212,W00009212,Output Areas and Small Areas,OASA,200,16,184
291798,W00009213,W00009213,Output Areas and Small Areas,OASA,246,76,170
291799,W00009214,W00009214,Output Areas and Small Areas,OASA,216,21,195
291800,W00009215,W00009215,Output Areas and Small Areas,OASA,248,13,235
291801,W00009216,W00009216,Output Areas and Small Areas,OASA,255,31,224
291802,W00009217,W00009217,Output Areas and Small Areas,OASA,227,10,217
291803,W00009218,W00009218,Output Areas and Small Areas,OASA,238,13,225
291804,W00009219,W00009219,Output Areas and Small Areas,OASA,244,40,204
291805,W00009220,W00009220,Output Areas and Small Areas,OASA,233,16,217
291806,W00009221,W00009221,Output Areas and Small Areas,OASA,243,11,232
291807,W00009222,W00009222,Output Areas and Small Areas,OASA,185,11,174
291808,W00009223,W00009223,Output Areas and Small Areas,OASA,215,5,210
291809,W00009224,W00009224,Output Areas and Small Areas,OASA,243,9,234
291810,W00009225,W00009225,Output Areas and Small Areas,OASA,267,21,246
291811,W00009226,W00009226,Output Areas and Small Areas,OASA,237,16,221
291812,W00009227,W00009227,Output Areas and Small Areas,OASA,229,24,205
291813,W00009228,W00009228,Output Areas and Small Areas,OASA,232,23,209
291814,W00009229,W00009229,Output Areas and Small Areas,OASA,267,32,235
291815,W00009230,W00009230,Output Areas and Small Areas,OASA,254,18,236
291816,W00009231,W00009231,Output Areas and Small Areas,OASA,195,11,184
291817,W00009232,W00009232,Output Areas and Small Areas,OASA,291,14,277
291818,W00009233,W00009233,Output Areas and Small Areas,OASA,292,19,273
291819,W00009234,W00009234,Output Areas and Small Areas,OASA,196,12,184
291820,W00009235,W00009235,Output Areas and Small Areas,OASA,221,26,195
291821,W00009236,W00009236,Output Areas and Small Areas,OASA,246,15,231
291822,W00009237,W00009237,Output Areas and Small Areas,OASA,359,15,344
291823,W00009238,W00009238,Output Areas and Small Areas,OASA,278,26,252
291824,W00009239,W00009239,Output Areas and Small Areas,OASA,237,9,228
291825,W00009240,W00009240,Output Areas and Small Areas,OASA,238,13,225
291826,W00009241,W00009241,Output Areas and Small Areas,OASA,327,12,315
291827,W00009242,W00009242,Output Areas and Small Areas,OASA,239,21,218
291828,W00009243,W00009243,Output Areas and Small Areas,OASA,287,16,271
291829,W00009244,W00009244,Output Areas and Small Areas,OASA,213,23,190
291830,W00009245,W00009245,Output Areas and Small Areas,OASA,372,46,326
291831,W00009246,W00009246,Output Areas and Small Areas,OASA,289,11,278
291832,W00009247,W00009247,Output Areas and Small Areas,OASA,241,20,221
291833,W00009248,W00009248,Output Areas and Small Areas,OASA,261,18,243
291834,W00009249,W00009249,Output Areas and Small Areas,OASA,255,23,232
291835,W00009250,W00009250,Output Areas and Small Areas,OASA,237,15,222
291836,W00009251,W00009251,Output Areas and Small Areas,OASA,247,33,214
291837,W00009252,W00009252,Output Areas and Small Areas,OASA,326,30,296
291838,W00009253,W00009253,Output Areas and Small Areas,OASA,225,5,220
291839,W00009254,W00009254,Output Areas and Small Areas,OASA,263,16,247
291840,W00009255,W00009255,Output Areas and Small Areas,OASA,250,14,236
291841,W00009256,W00009256,Output Areas and Small Areas,OASA,259,24,235
291842,W00009258,W00009258,Output Areas and Small Areas,OASA,259,12,247
291843,W00009259,W00009259,Output Areas and Small Areas,OASA,195,9,186
291844,W00009260,W00009260,Output Areas and Small Areas,OASA,237,5,232
291845,W00009261,W00009261,Output Areas and Small Areas,OASA,308,24,284
291846,W00009262,W00009262,Output Areas and Small Areas,OASA,244,15,229
291847,W00009263,W00009263,Output Areas and Small Areas,OASA,338,33,305
291848,W00009264,W00009264,Output Areas and Small Areas,OASA,255,18,237
291849,W00009265,W00009265,Output Areas and Small Areas,OASA,215,22,193
291850,W00009266,W00009266,Output Areas and Small Areas,OASA,205,30,175
291851,W00009267,W00009267,Output Areas and Small Areas,OASA,206,20,186
291852,W00009268,W00009268,Output Areas and Small Areas,OASA,204,9,195
291853,W00009269,W00009269,Output Areas and Small Areas,OASA,187,8,179
291854,W00009270,W00009270,Output Areas and Small Areas,OASA,239,16,223
291855,W00009271,W00009271,Output Areas and Small Areas,OASA,218,18,200
291856,W00009272,W00009272,Output Areas and Small Areas,OASA,254,24,230
291857,W00009273,W00009273,Output Areas and Small Areas,OASA,203,15,188
291858,W00009274,W00009274,Output Areas and Small Areas,OASA,266,33,233
291859,W00009275,W00009275,Output Areas and Small Areas,OASA,229,15,214
291860,W00009276,W00009276,Output Areas and Small Areas,OASA,275,23,252
291861,W00009277,W00009277,Output Areas and Small Areas,OASA,252,23,229
291862,W00009278,W00009278,Output Areas and Small Areas,OASA,225,11,214
291863,W00009279,W00009279,Output Areas and Small Areas,OASA,231,13,218
291864,W00009280,W00009280,Output Areas and Small Areas,OASA,253,17,236
291865,W00009281,W00009281,Output Areas and Small Areas,OASA,278,9,269
291866,W00009282,W00009282,Output Areas and Small Areas,OASA,208,18,190
291867,W00009283,W00009283,Output Areas and Small Areas,OASA,258,22,236
291868,W00009284,W00009284,Output Areas and Small Areas,OASA,271,13,258
291869,W00009285,W00009285,Output Areas and Small Areas,OASA,255,19,236
291870,W00009286,W00009286,Output Areas and Small Areas,OASA,222,15,207
291871,W00009287,W00009287,Output Areas and Small Areas,OASA,243,25,218
291872,W00009288,W00009288,Output Areas and Small Areas,OASA,240,11,229
291873,W00009289,W00009289,Output Areas and Small Areas,OASA,254,10,244
291874,W00009290,W00009290,Output Areas and Small Areas,OASA,232,14,218
291875,W00009291,W00009291,Output Areas and Small Areas,OASA,208,6,202
291876,W00009292,W00009292,Output Areas and Small Areas,OASA,302,32,270
291877,W00009293,W00009293,Output Areas and Small Areas,OASA,289,17,272
291878,W00009294,W00009294,Output Areas and Small Areas,OASA,201,2,199
291879,W00009295,W00009295,Output Areas and Small Areas,OASA,294,7,287
291880,W00009296,W00009296,Output Areas and Small Areas,OASA,218,8,210
291881,W00009297,W00009297,Output Areas and Small Areas,OASA,262,6,256
291882,W00009298,W00009298,Output Areas and Small Areas,OASA,254,4,250
291883,W00009299,W00009299,Output Areas and Small Areas,OASA,217,8,209
291884,W00009300,W00009300,Output Areas and Small Areas,OASA,225,3,222
291885,W00009301,W00009301,Output Areas and Small Areas,OASA,156,8,148
291886,W00009302,W00009302,Output Areas and Small Areas,OASA,282,12,270
291887,W00009303,W00009303,Output Areas and Small Areas,OASA,222,9,213
291888,W00009304,W00009304,Output Areas and Small Areas,OASA,282,15,267
291889,W00009305,W00009305,Output Areas and Small Areas,OASA,195,7,188
291890,W00009306,W00009306,Output Areas and Small Areas,OASA,188,8,180
291891,W00009307,W00009307,Output Areas and Small Areas,OASA,248,12,236
291892,W00009308,W00009308,Output Areas and Small Areas,OASA,191,6,185
291893,W00009309,W00009309,Output Areas and Small Areas,OASA,249,8,241
291894,W00009310,W00009310,Output Areas and Small Areas,OASA,257,9,248
291895,W00009311,W00009311,Output Areas and Small Areas,OASA,250,10,240
291896,W00009312,W00009312,Output Areas and Small Areas,OASA,261,9,252
291897,W00009313,W00009313,Output Areas and Small Areas,OASA,187,10,177
291898,W00009314,W00009314,Output Areas and Small Areas,OASA,218,7,211
291899,W00009315,W00009315,Output Areas and Small Areas,OASA,243,15,228
291900,W00009316,W00009316,Output Areas and Small Areas,OASA,217,7,210
291901,W00009317,W00009317,Output Areas and Small Areas,OASA,238,5,233
291902,W00009318,W00009318,Output Areas and Small Areas,OASA,232,10,222
291903,W00009319,W00009319,Output Areas and Small Areas,OASA,192,5,187
291904,W00009320,W00009320,Output Areas and Small Areas,OASA,232,6,226
291905,W00009321,W00009321,Output Areas and Small Areas,OASA,212,13,199
291906,W00009322,W00009322,Output Areas and Small Areas,OASA,251,5,246
291907,W00009323,W00009323,Output Areas and Small Areas,OASA,233,3,230
291908,W00009324,W00009324,Output Areas and Small Areas,OASA,230,12,218
291909,W00009325,W00009325,Output Areas and Small Areas,OASA,248,9,239
291910,W00009326,W00009326,Output Areas and Small Areas,OASA,204,7,197
291911,W00009327,W00009327,Output Areas and Small Areas,OASA,231,6,225
291912,W00009328,W00009328,Output Areas and Small Areas,OASA,303,16,287
291913,W00009329,W00009329,Output Areas and Small Areas,OASA,274,11,263
291914,W00009330,W00009330,Output Areas and Small Areas,OASA,293,5,288
291915,W00009331,W00009331,Output Areas and Small Areas,OASA,313,15,298
291916,W00009332,W00009332,Output Areas and Small Areas,OASA,241,12,229
291917,W00009333,W00009333,Output Areas and Small Areas,OASA,284,20,264
291918,W00009334,W00009334,Output Areas and Small Areas,OASA,220,14,206
291919,W00009335,W00009335,Output Areas and Small Areas,OASA,283,17,266
291920,W00009336,W00009336,Output Areas and Small Areas,OASA,236,16,220
291921,W00009337,W00009337,Output Areas and Small Areas,OASA,324,19,305
291922,W00009338,W00009338,Output Areas and Small Areas,OASA,231,17,214
291923,W00009339,W00009339,Output Areas and Small Areas,OASA,215,6,209
291924,W00009340,W00009340,Output Areas and Small Areas,OASA,228,9,219
291925,W00009341,W00009341,Output Areas and Small Areas,OASA,222,12,210
291926,W00009342,W00009342,Output Areas and Small Areas,OASA,281,11,270
291927,W00009343,W00009343,Output Areas and Small Areas,OASA,234,8,226
291928,W00009344,W00009344,Output Areas and Small Areas,OASA,272,11,261
291929,W00009345,W00009345,Output Areas and Small Areas,OASA,264,7,257
291930,W00009346,W00009346,Output Areas and Small Areas,OASA,265,5,260
291931,W00009347,W00009347,Output Areas and Small Areas,OASA,183,9,174
291932,W00009348,W00009348,Output Areas and Small Areas,OASA,291,25,266
291933,W00009349,W00009349,Output Areas and Small Areas,OASA,258,10,248
291934,W00009350,W00009350,Output Areas and Small Areas,OASA,203,7,196
291935,W00009351,W00009351,Output Areas and Small Areas,OASA,242,7,235
291936,W00009352,W00009352,Output Areas and Small Areas,OASA,251,5,246
291937,W00009353,W00009353,Output Areas and Small Areas,OASA,247,6,241
291938,W00009354,W00009354,Output Areas and Small Areas,OASA,251,1,250
291939,W00009355,W00009355,Output Areas and Small Areas,OASA,231,13,218
291940,W00009356,W00009356,Output Areas and Small Areas,OASA,311,17,294
291941,W00009357,W00009357,Output Areas and Small Areas,OASA,220,8,212
291942,W00009358,W00009358,Output Areas and Small Areas,OASA,182,8,174
291943,W00009359,W00009359,Output Areas and Small Areas,OASA,205,8,197
291944,W00009360,W00009360,Output Areas and Small Areas,OASA,241,6,235
291945,W00009361,W00009361,Output Areas and Small Areas,OASA,287,3,284
291946,W00009362,W00009362,Output Areas and Small Areas,OASA,250,9,241
291947,W00009363,W00009363,Output Areas and Small Areas,OASA,191,12,179
291948,W00009364,W00009364,Output Areas and Small Areas,OASA,270,11,259
291949,W00009365,W00009365,Output Areas and Small Areas,OASA,211,7,204
291950,W00009366,W00009366,Output Areas and Small Areas,OASA,268,19,249
291951,W00009367,W00009367,Output Areas and Small Areas,OASA,231,17,214
291952,W00009368,W00009368,Output Areas and Small Areas,OASA,245,19,226
291953,W00009369,W00009369,Output Areas and Small Areas,OASA,301,5,296
291954,W00009371,W00009371,Output Areas and Small Areas,OASA,272,14,258
291955,W00009372,W00009372,Output Areas and Small Areas,OASA,259,10,249
291956,W00009373,W00009373,Output Areas and Small Areas,OASA,274,12,262
291957,W00009374,W00009374,Output Areas and Small Areas,OASA,242,8,234
291958,W00009375,W00009375,Output Areas and Small Areas,OASA,353,69,284
291959,W00009376,W00009376,Output Areas and Small Areas,OASA,326,45,281
291960,W00009377,W00009377,Output Areas and Small Areas,OASA,232,39,193
291961,W00009378,W00009378,Output Areas and Small Areas,OASA,194,11,183
291962,W00009379,W00009379,Output Areas and Small Areas,OASA,198,16,182
291963,W00009380,W00009380,Output Areas and Small Areas,OASA,260,35,225
291964,W00009381,W00009381,Output Areas and Small Areas,OASA,250,27,223
291965,W00009382,W00009382,Output Areas and Small Areas,OASA,225,25,200
291966,W00009383,W00009383,Output Areas and Small Areas,OASA,246,48,198
291967,W00009384,W00009384,Output Areas and Small Areas,OASA,265,48,217
291968,W00009385,W00009385,Output Areas and Small Areas,OASA,264,42,222
291969,W00009386,W00009386,Output Areas and Small Areas,OASA,201,8,193
291970,W00009387,W00009387,Output Areas and Small Areas,OASA,246,24,222
291971,W00009389,W00009389,Output Areas and Small Areas,OASA,305,41,264
291972,W00009390,W00009390,Output Areas and Small Areas,OASA,307,48,259
291973,W00009391,W00009391,Output Areas and Small Areas,OASA,341,29,312
291974,W00009392,W00009392,Output Areas and Small Areas,OASA,274,37,237
291975,W00009393,W00009393,Output Areas and Small Areas,OASA,206,17,189
291976,W00009394,W00009394,Output Areas and Small Areas,OASA,298,42,256
291977,W00009395,W00009395,Output Areas and Small Areas,OASA,249,53,196
291978,W00009396,W00009396,Output Areas and Small Areas,OASA,318,38,280
291979,W00009397,W00009397,Output Areas and Small Areas,OASA,292,33,259
291980,W00009398,W00009398,Output Areas and Small Areas,OASA,209,14,195
291981,W00009399,W00009399,Output Areas and Small Areas,OASA,245,31,214
291982,W00009400,W00009400,Output Areas and Small Areas,OASA,296,37,259
291983,W00009401,W00009401,Output Areas and Small Areas,OASA,276,27,249
291984,W00009402,W00009402,Output Areas and Small Areas,OASA,222,22,200
291985,W00009403,W00009403,Output Areas and Small Areas,OASA,291,29,262
291986,W00009404,W00009404,Output Areas and Small Areas,OASA,215,19,196
291987,W00009405,W00009405,Output Areas and Small Areas,OASA,227,13,214
291988,W00009407,W00009407,Output Areas and Small Areas,OASA,266,46,220
291989,W00009408,W00009408,Output Areas and Small Areas,OASA,285,10,275
291990,W00009409,W00009409,Output Areas and Small Areas,OASA,262,16,246
291991,W00009410,W00009410,Output Areas and Small Areas,OASA,251,20,231
291992,W00009411,W00009411,Output Areas and Small Areas,OASA,353,35,318
291993,W00009412,W00009412,Output Areas and Small Areas,OASA,258,26,232
291994,W00009413,W00009413,Output Areas and Small Areas,OASA,234,25,209
291995,W00009414,W00009414,Output Areas and Small Areas,OASA,248,18,230
291996,W00009415,W00009415,Output Areas and Small Areas,OASA,275,19,256
291997,W00009416,W00009416,Output Areas and Small Areas,OASA,283,27,256
291998,W00009417,W00009417,Output Areas and Small Areas,OASA,270,12,258
291999,W00009418,W00009418,Output Areas and Small Areas,OASA,218,25,193
292000,W00009419,W00009419,Output Areas and Small Areas,OASA,254,48,206
292001,W00009420,W00009420,Output Areas and Small Areas,OASA,290,21,269
292002,W00009421,W00009421,Output Areas and Small Areas,OASA,250,19,231
292003,W00009422,W00009422,Output Areas and Small Areas,OASA,258,21,237
292004,W00009423,W00009423,Output Areas and Small Areas,OASA,296,19,277
292005,W00009424,W00009424,Output Areas and Small Areas,OASA,376,39,337
292006,W00009425,W00009425,Output Areas and Small Areas,OASA,262,18,244
292007,W00009426,W00009426,Output Areas and Small Areas,OASA,255,24,231
292008,W00009427,W00009427,Output Areas and Small Areas,OASA,268,25,243
292009,W00009428,W00009428,Output Areas and Small Areas,OASA,376,31,345
292010,W00009429,W00009429,Output Areas and Small Areas,OASA,282,27,255
292011,W00009430,W00009430,Output Areas and Small Areas,OASA,234,23,211
292012,W00009431,W00009431,Output Areas and Small Areas,OASA,209,13,196
292013,W00009432,W00009432,Output Areas and Small Areas,OASA,224,18,206
292014,W00009433,W00009433,Output Areas and Small Areas,OASA,446,30,416
292015,W00009434,W00009434,Output Areas and Small Areas,OASA,341,29,312
292016,W00009435,W00009435,Output Areas and Small Areas,OASA,236,14,222
292017,W00009436,W00009436,Output Areas and Small Areas,OASA,294,19,275
292018,W00009437,W00009437,Output Areas and Small Areas,OASA,485,39,446
292019,W00009438,W00009438,Output Areas and Small Areas,OASA,218,17,201
292020,W00009439,W00009439,Output Areas and Small Areas,OASA,263,30,233
292021,W00009440,W00009440,Output Areas and Small Areas,OASA,271,13,258
292022,W00009441,W00009441,Output Areas and Small Areas,OASA,307,23,284
292023,W00009442,W00009442,Output Areas and Small Areas,OASA,184,8,176
292024,W00009443,W00009443,Output Areas and Small Areas,OASA,304,21,283
292025,W00009444,W00009444,Output Areas and Small Areas,OASA,296,27,269
292026,W00009445,W00009445,Output Areas and Small Areas,OASA,192,5,187
292027,W00009446,W00009446,Output Areas and Small Areas,OASA,382,24,358
292028,W00009447,W00009447,Output Areas and Small Areas,OASA,205,9,196
292029,W00009448,W00009448,Output Areas and Small Areas,OASA,325,38,287
292030,W00009449,W00009449,Output Areas and Small Areas,OASA,340,24,316
292031,W00009450,W00009450,Output Areas and Small Areas,OASA,208,7,201
292032,W00009451,W00009451,Output Areas and Small Areas,OASA,375,30,345
292033,W00009452,W00009452,Output Areas and Small Areas,OASA,315,38,277
292034,W00009453,W00009453,Output Areas and Small Areas,OASA,336,43,293
292035,W00009454,W00009454,Output Areas and Small Areas,OASA,429,38,391
292036,W00009455,W00009455,Output Areas and Small Areas,OASA,177,9,168
292037,W00009456,W00009456,Output Areas and Small Areas,OASA,349,38,311
292038,W00009457,W00009457,Output Areas and Small Areas,OASA,329,38,291
292039,W00009458,W00009458,Output Areas and Small Areas,OASA,272,41,231
292040,W00009459,W00009459,Output Areas and Small Areas,OASA,300,27,273
292041,W00009460,W00009460,Output Areas and Small Areas,OASA,363,29,334
292042,W00009461,W00009461,Output Areas and Small Areas,OASA,278,32,246
292043,W00009462,W00009462,Output Areas and Small Areas,OASA,318,43,275
292044,W00009463,W00009463,Output Areas and Small Areas,OASA,315,22,293
292045,W00009464,W00009464,Output Areas and Small Areas,OASA,261,27,234
292046,W00009465,W00009465,Output Areas and Small Areas,OASA,386,35,351
292047,W00009466,W00009466,Output Areas and Small Areas,OASA,324,24,300
292048,W00009467,W00009467,Output Areas and Small Areas,OASA,317,33,284
292049,W00009468,W00009468,Output Areas and Small Areas,OASA,445,52,393
292050,W00009469,W00009469,Output Areas and Small Areas,OASA,221,25,196
292051,W00009470,W00009470,Output Areas and Small Areas,OASA,235,20,215
292052,W00009471,W00009471,Output Areas and Small Areas,OASA,491,25,466
292053,W00009472,W00009472,Output Areas and Small Areas,OASA,196,24,172
292054,W00009473,W00009473,Output Areas and Small Areas,OASA,292,24,268
292055,W00009474,W00009474,Output Areas and Small Areas,OASA,265,28,237
292056,W00009475,W00009475,Output Areas and Small Areas,OASA,265,24,241
292057,W00009476,W00009476,Output Areas and Small Areas,OASA,398,39,359
292058,W00009477,W00009477,Output Areas and Small Areas,OASA,355,19,336
292059,W00009478,W00009478,Output Areas and Small Areas,OASA,285,13,272
292060,W00009479,W00009479,Output Areas and Small Areas,OASA,218,10,208
292061,W00009480,W00009480,Output Areas and Small Areas,OASA,206,6,200
292062,W00009481,W00009481,Output Areas and Small Areas,OASA,313,18,295
292063,W00009482,W00009482,Output Areas and Small Areas,OASA,272,10,262
292064,W00009483,W00009483,Output Areas and Small Areas,OASA,147,11,136
292065,W00009484,W00009484,Output Areas and Small Areas,OASA,167,7,160
292066,W00009486,W00009486,Output Areas and Small Areas,OASA,291,24,267
292067,W00009487,W00009487,Output Areas and Small Areas,OASA,245,16,229
292068,W00009488,W00009488,Output Areas and Small Areas,OASA,305,22,283
292069,W00009489,W00009489,Output Areas and Small Areas,OASA,230,18,212
292070,W00009490,W00009490,Output Areas and Small Areas,OASA,357,33,324
292071,W00009491,W00009491,Output Areas and Small Areas,OASA,354,37,317
292072,W00009492,W00009492,Output Areas and Small Areas,OASA,174,5,169
292073,W00009493,W00009493,Output Areas and Small Areas,OASA,239,16,223
292074,W00009494,W00009494,Output Areas and Small Areas,OASA,361,29,332
292075,W00009495,W00009495,Output Areas and Small Areas,OASA,246,13,233
292076,W00009496,W00009496,Output Areas and Small Areas,OASA,268,27,241
292077,W00009497,W00009497,Output Areas and Small Areas,OASA,326,16,310
292078,W00009499,W00009499,Output Areas and Small Areas,OASA,229,10,219
292079,W00009500,W00009500,Output Areas and Small Areas,OASA,231,12,219
292080,W00009501,W00009501,Output Areas and Small Areas,OASA,284,18,266
292081,W00009502,W00009502,Output Areas and Small Areas,OASA,281,24,257
292082,W00009503,W00009503,Output Areas and Small Areas,OASA,463,47,416
292083,W00009505,W00009505,Output Areas and Small Areas,OASA,207,22,185
292084,W00009506,W00009506,Output Areas and Small Areas,OASA,261,11,250
292085,W00009507,W00009507,Output Areas and Small Areas,OASA,275,25,250
292086,W00009508,W00009508,Output Areas and Small Areas,OASA,275,21,254
292087,W00009509,W00009509,Output Areas and Small Areas,OASA,260,27,233
292088,W00009510,W00009510,Output Areas and Small Areas,OASA,259,26,233
292089,W00009511,W00009511,Output Areas and Small Areas,OASA,278,50,228
292090,W00009512,W00009512,Output Areas and Small Areas,OASA,325,38,287
292091,W00009514,W00009514,Output Areas and Small Areas,OASA,258,19,239
292092,W00009515,W00009515,Output Areas and Small Areas,OASA,224,21,203
292093,W00009516,W00009516,Output Areas and Small Areas,OASA,346,36,310
292094,W00009517,W00009517,Output Areas and Small Areas,OASA,246,22,224
292095,W00009518,W00009518,Output Areas and Small Areas,OASA,215,24,191
292096,W00009519,W00009519,Output Areas and Small Areas,OASA,209,12,197
292097,W00009520,W00009520,Output Areas and Small Areas,OASA,230,29,201
292098,W00009521,W00009521,Output Areas and Small Areas,OASA,227,17,210
292099,W00009522,W00009522,Output Areas and Small Areas,OASA,232,22,210
292100,W00009523,W00009523,Output Areas and Small Areas,OASA,475,51,424
292101,W00009524,W00009524,Output Areas and Small Areas,OASA,236,16,220
292102,W00009525,W00009525,Output Areas and Small Areas,OASA,261,28,233
292103,W00009526,W00009526,Output Areas and Small Areas,OASA,297,46,251
292104,W00009527,W00009527,Output Areas and Small Areas,OASA,264,28,236
292105,W00009528,W00009528,Output Areas and Small Areas,OASA,236,25,211
292106,W00009529,W00009529,Output Areas and Small Areas,OASA,277,31,246
292107,W00009530,W00009530,Output Areas and Small Areas,OASA,243,26,217
292108,W00009531,W00009531,Output Areas and Small Areas,OASA,232,18,214
292109,W00009532,W00009532,Output Areas and Small Areas,OASA,265,21,244
292110,W00009533,W00009533,Output Areas and Small Areas,OASA,230,23,207
292111,W00009534,W00009534,Output Areas and Small Areas,OASA,195,11,184
292112,W00009535,W00009535,Output Areas and Small Areas,OASA,233,15,218
292113,W00009536,W00009536,Output Areas and Small Areas,OASA,224,19,205
292114,W00009537,W00009537,Output Areas and Small Areas,OASA,189,19,170
292115,W00009538,W00009538,Output Areas and Small Areas,OASA,188,18,170
292116,W00009539,W00009539,Output Areas and Small Areas,OASA,248,35,213
292117,W00009540,W00009540,Output Areas and Small Areas,OASA,258,31,227
292118,W00009541,W00009541,Output Areas and Small Areas,OASA,217,16,201
292119,W00009542,W00009542,Output Areas and Small Areas,OASA,201,34,167
292120,W00009543,W00009543,Output Areas and Small Areas,OASA,263,33,230
292121,W00009544,W00009544,Output Areas and Small Areas,OASA,228,23,205
292122,W00009545,W00009545,Output Areas and Small Areas,OASA,228,20,208
292123,W00009546,W00009546,Output Areas and Small Areas,OASA,221,30,191
292124,W00009547,W00009547,Output Areas and Small Areas,OASA,221,20,201
292125,W00009548,W00009548,Output Areas and Small Areas,OASA,202,22,180
292126,W00009549,W00009549,Output Areas and Small Areas,OASA,249,21,228
292127,W00009550,W00009550,Output Areas and Small Areas,OASA,224,21,203
292128,W00009551,W00009551,Output Areas and Small Areas,OASA,209,21,188
292129,W00009552,W00009552,Output Areas and Small Areas,OASA,220,22,198
292130,W00009553,W00009553,Output Areas and Small Areas,OASA,255,14,241
292131,W00009554,W00009554,Output Areas and Small Areas,OASA,198,22,176
292132,W00009555,W00009555,Output Areas and Small Areas,OASA,229,26,203
292133,W00009556,W00009556,Output Areas and Small Areas,OASA,252,18,234
292134,W00009557,W00009557,Output Areas and Small Areas,OASA,360,21,339
292135,W00009558,W00009558,Output Areas and Small Areas,OASA,259,42,217
292136,W00009559,W00009559,Output Areas and Small Areas,OASA,278,28,250
292137,W00009560,W00009560,Output Areas and Small Areas,OASA,360,14,346
292138,W00009561,W00009561,Output Areas and Small Areas,OASA,216,10,206
292139,W00009562,W00009562,Output Areas and Small Areas,OASA,218,8,210
292140,W00009563,W00009563,Output Areas and Small Areas,OASA,245,17,228
292141,W00009564,W00009564,Output Areas and Small Areas,OASA,241,38,203
292142,W00009565,W00009565,Output Areas and Small Areas,OASA,304,21,283
292143,W00009566,W00009566,Output Areas and Small Areas,OASA,283,18,265
292144,W00009567,W00009567,Output Areas and Small Areas,OASA,194,7,187
292145,W00009568,W00009568,Output Areas and Small Areas,OASA,266,9,257
292146,W00009569,W00009569,Output Areas and Small Areas,OASA,230,20,210
292147,W00009570,W00009570,Output Areas and Small Areas,OASA,365,16,349
292148,W00009571,W00009571,Output Areas and Small Areas,OASA,288,14,274
292149,W00009572,W00009572,Output Areas and Small Areas,OASA,353,41,312
292150,W00009573,W00009573,Output Areas and Small Areas,OASA,251,17,234
292151,W00009574,W00009574,Output Areas and Small Areas,OASA,299,14,285
292152,W00009575,W00009575,Output Areas and Small Areas,OASA,191,10,181
292153,W00009576,W00009576,Output Areas and Small Areas,OASA,205,23,182
292154,W00009577,W00009577,Output Areas and Small Areas,OASA,226,51,175
292155,W00009578,W00009578,Output Areas and Small Areas,OASA,251,64,187
292156,W00009579,W00009579,Output Areas and Small Areas,OASA,198,32,166
292157,W00009580,W00009580,Output Areas and Small Areas,OASA,329,34,295
292158,W00009581,W00009581,Output Areas and Small Areas,OASA,251,47,204
292159,W00009582,W00009582,Output Areas and Small Areas,OASA,278,43,235
292160,W00009583,W00009583,Output Areas and Small Areas,OASA,272,55,217
292161,W00009584,W00009584,Output Areas and Small Areas,OASA,260,50,210
292162,W00009585,W00009585,Output Areas and Small Areas,OASA,246,48,198
292163,W00009586,W00009586,Output Areas and Small Areas,OASA,213,27,186
292164,W00009587,W00009587,Output Areas and Small Areas,OASA,199,41,158
292165,W00009588,W00009588,Output Areas and Small Areas,OASA,294,30,264
292166,W00009589,W00009589,Output Areas and Small Areas,OASA,243,33,210
292167,W00009590,W00009590,Output Areas and Small Areas,OASA,215,59,156
292168,W00009591,W00009591,Output Areas and Small Areas,OASA,273,32,241
292169,W00009592,W00009592,Output Areas and Small Areas,OASA,295,39,256
292170,W00009593,W00009593,Output Areas and Small Areas,OASA,202,30,172
292171,W00009594,W00009594,Output Areas and Small Areas,OASA,278,49,229
292172,W00009595,W00009595,Output Areas and Small Areas,OASA,369,80,289
292173,W00009596,W00009596,Output Areas and Small Areas,OASA,240,48,192
292174,W00009597,W00009597,Output Areas and Small Areas,OASA,342,43,299
292175,W00009598,W00009598,Output Areas and Small Areas,OASA,267,12,255
292176,W00009599,W00009599,Output Areas and Small Areas,OASA,235,21,214
292177,W00009600,W00009600,Output Areas and Small Areas,OASA,333,8,325
292178,W00009601,W00009601,Output Areas and Small Areas,OASA,248,9,239
292179,W00009602,W00009602,Output Areas and Small Areas,OASA,234,3,231
292180,W00009603,W00009603,Output Areas and Small Areas,OASA,264,6,258
292181,W00009604,W00009604,Output Areas and Small Areas,OASA,217,7,210
292182,W00009605,W00009605,Output Areas and Small Areas,OASA,263,16,247
292183,W00009606,W00009606,Output Areas and Small Areas,OASA,256,12,244
292184,W00009607,W00009607,Output Areas and Small Areas,OASA,271,18,253
292185,W00009608,W00009608,Output Areas and Small Areas,OASA,275,13,262
292186,W00009609,W00009609,Output Areas and Small Areas,OASA,257,15,242
292187,W00009610,W00009610,Output Areas and Small Areas,OASA,309,22,287
292188,W00009611,W00009611,Output Areas and Small Areas,OASA,277,13,264
292189,W00009612,W00009612,Output Areas and Small Areas,OASA,263,17,246
292190,W00009613,W00009613,Output Areas and Small Areas,OASA,255,13,242
292191,W00009614,W00009614,Output Areas and Small Areas,OASA,258,19,239
292192,W00009615,W00009615,Output Areas and Small Areas,OASA,256,7,249
292193,W00009616,W00009616,Output Areas and Small Areas,OASA,241,3,238
292194,W00009617,W00009617,Output Areas and Small Areas,OASA,184,3,181
292195,W00009618,W00009618,Output Areas and Small Areas,OASA,219,14,205
292196,W00009619,W00009619,Output Areas and Small Areas,OASA,272,11,261
292197,W00009620,W00009620,Output Areas and Small Areas,OASA,223,8,215
292198,W00009621,W00009621,Output Areas and Small Areas,OASA,242,8,234
292199,W00009622,W00009622,Output Areas and Small Areas,OASA,227,6,221
292200,W00009623,W00009623,Output Areas and Small Areas,OASA,230,12,218
292201,W00009624,W00009624,Output Areas and Small Areas,OASA,293,13,280
292202,W00009625,W00009625,Output Areas and Small Areas,OASA,204,6,198
292203,W00009626,W00009626,Output Areas and Small Areas,OASA,256,7,249
292204,W00009627,W00009627,Output Areas and Small Areas,OASA,246,12,234
292205,W00009629,W00009629,Output Areas and Small Areas,OASA,287,19,268
292206,W00009630,W00009630,Output Areas and Small Areas,OASA,296,25,271
292207,W00009631,W00009631,Output Areas and Small Areas,OASA,209,8,201
292208,W00009632,W00009632,Output Areas and Small Areas,OASA,265,25,240
292209,W00009633,W00009633,Output Areas and Small Areas,OASA,239,10,229
292210,W00009634,W00009634,Output Areas and Small Areas,OASA,249,26,223
292211,W00009635,W00009635,Output Areas and Small Areas,OASA,246,24,222
292212,W00009636,W00009636,Output Areas and Small Areas,OASA,206,19,187
292213,W00009637,W00009637,Output Areas and Small Areas,OASA,260,25,235
292214,W00009638,W00009638,Output Areas and Small Areas,OASA,202,4,198
292215,W00009639,W00009639,Output Areas and Small Areas,OASA,288,15,273
292216,W00009640,W00009640,Output Areas and Small Areas,OASA,262,15,247
292217,W00009641,W00009641,Output Areas and Small Areas,OASA,200,12,188
292218,W00009642,W00009642,Output Areas and Small Areas,OASA,229,13,216
292219,W00009643,W00009643,Output Areas and Small Areas,OASA,201,19,182
292220,W00009644,W00009644,Output Areas and Small Areas,OASA,182,12,170
292221,W00009645,W00009645,Output Areas and Small Areas,OASA,325,8,317
292222,W00009646,W00009646,Output Areas and Small Areas,OASA,264,4,260
292223,W00009647,W00009647,Output Areas and Small Areas,OASA,215,13,202
292224,W00009648,W00009648,Output Areas and Small Areas,OASA,207,6,201
292225,W00009649,W00009649,Output Areas and Small Areas,OASA,225,13,212
292226,W00009650,W00009650,Output Areas and Small Areas,OASA,208,15,193
292227,W00009651,W00009651,Output Areas and Small Areas,OASA,252,14,238
292228,W00009652,W00009652,Output Areas and Small Areas,OASA,245,7,238
292229,W00009653,W00009653,Output Areas and Small Areas,OASA,265,14,251
292230,W00009654,W00009654,Output Areas and Small Areas,OASA,226,9,217
292231,W00009655,W00009655,Output Areas and Small Areas,OASA,234,8,226
292232,W00009656,W00009656,Output Areas and Small Areas,OASA,355,18,337
292233,W00009657,W00009657,Output Areas and Small Areas,OASA,166,7,159
292234,W00009658,W00009658,Output Areas and Small Areas,OASA,226,12,214
292235,W00009659,W00009659,Output Areas and Small Areas,OASA,239,9,230
292236,W00009660,W00009660,Output Areas and Small Areas,OASA,224,17,207
292237,W00009661,W00009661,Output Areas and Small Areas,OASA,265,17,248
292238,W00009662,W00009662,Output Areas and Small Areas,OASA,221,8,213
292239,W00009663,W00009663,Output Areas and Small Areas,OASA,214,7,207
292240,W00009664,W00009664,Output Areas and Small Areas,OASA,258,23,235
292241,W00009665,W00009665,Output Areas and Small Areas,OASA,193,4,189
292242,W00009666,W00009666,Output Areas and Small Areas,OASA,131,4,127
292243,W00009667,W00009667,Output Areas and Small Areas,OASA,189,15,174
292244,W00009668,W00009668,Output Areas and Small Areas,OASA,229,23,206
292245,W00009669,W00009669,Output Areas and Small Areas,OASA,334,8,326
292246,W00009670,W00009670,Output Areas and Small Areas,OASA,310,15,295
292247,W00009671,W00009671,Output Areas and Small Areas,OASA,188,11,177
292248,W00009672,W00009672,Output Areas and Small Areas,OASA,194,2,192
292249,W00009673,W00009673,Output Areas and Small Areas,OASA,244,5,239
292250,W00009675,W00009675,Output Areas and Small Areas,OASA,240,7,233
292251,W00009676,W00009676,Output Areas and Small Areas,OASA,182,3,179
292252,W00009677,W00009677,Output Areas and Small Areas,OASA,262,11,251
292253,W00009678,W00009678,Output Areas and Small Areas,OASA,218,6,212
292254,W00009679,W00009679,Output Areas and Small Areas,OASA,300,8,292
292255,W00009680,W00009680,Output Areas and Small Areas,OASA,232,6,226
292256,W00009681,W00009681,Output Areas and Small Areas,OASA,237,5,232
292257,W00009682,W00009682,Output Areas and Small Areas,OASA,277,6,271
292258,W00009683,W00009683,Output Areas and Small Areas,OASA,260,14,246
292259,W00009684,W00009684,Output Areas and Small Areas,OASA,235,10,225
292260,W00009685,W00009685,Output Areas and Small Areas,OASA,330,19,311
292261,W00009686,W00009686,Output Areas and Small Areas,OASA,217,9,208
292262,W00009687,W00009687,Output Areas and Small Areas,OASA,292,12,280
292263,W00009688,W00009688,Output Areas and Small Areas,OASA,271,11,260
292264,W00009689,W00009689,Output Areas and Small Areas,OASA,197,10,187
292265,W00009690,W00009690,Output Areas and Small Areas,OASA,256,11,245
292266,W00009691,W00009691,Output Areas and Small Areas,OASA,410,25,385
292267,W00009692,W00009692,Output Areas and Small Areas,OASA,302,16,286
292268,W00009693,W00009693,Output Areas and Small Areas,OASA,284,7,277
292269,W00009694,W00009694,Output Areas and Small Areas,OASA,225,8,217
292270,W00009695,W00009695,Output Areas and Small Areas,OASA,205,9,196
292271,W00009696,W00009696,Output Areas and Small Areas,OASA,231,11,220
292272,W00009697,W00009697,Output Areas and Small Areas,OASA,220,8,212
292273,W00009698,W00009698,Output Areas and Small Areas,OASA,219,15,204
292274,W00009699,W00009699,Output Areas and Small Areas,OASA,178,5,173
292275,W00009700,W00009700,Output Areas and Small Areas,OASA,217,5,212
292276,W00009701,W00009701,Output Areas and Small Areas,OASA,176,6,170
292277,W00009702,W00009702,Output Areas and Small Areas,OASA,266,12,254
292278,W00009703,W00009703,Output Areas and Small Areas,OASA,159,7,152
292279,W00009704,W00009704,Output Areas and Small Areas,OASA,231,15,216
292280,W00009705,W00009705,Output Areas and Small Areas,OASA,220,9,211
292281,W00009706,W00009706,Output Areas and Small Areas,OASA,214,12,202
292282,W00009707,W00009707,Output Areas and Small Areas,OASA,173,4,169
292283,W00009708,W00009708,Output Areas and Small Areas,OASA,188,8,180
292284,W00009709,W00009709,Output Areas and Small Areas,OASA,439,48,391
292285,W00009710,W00009710,Output Areas and Small Areas,OASA,267,7,260
292286,W00009711,W00009711,Output Areas and Small Areas,OASA,272,18,254
292287,W00009712,W00009712,Output Areas and Small Areas,OASA,235,2,233
292288,W00009713,W00009713,Output Areas and Small Areas,OASA,266,4,262
292289,W00009714,W00009714,Output Areas and Small Areas,OASA,228,6,222
292290,W00009715,W00009715,Output Areas and Small Areas,OASA,221,5,216
292291,W00009716,W00009716,Output Areas and Small Areas,OASA,257,26,231
292292,W00009717,W00009717,Output Areas and Small Areas,OASA,259,27,232
292293,W00009718,W00009718,Output Areas and Small Areas,OASA,274,26,248
292294,W00009719,W00009719,Output Areas and Small Areas,OASA,252,22,230
292295,W00009720,W00009720,Output Areas and Small Areas,OASA,247,27,220
292296,W00009721,W00009721,Output Areas and Small Areas,OASA,223,11,212
292297,W00009722,W00009722,Output Areas and Small Areas,OASA,228,30,198
292298,W00009723,W00009723,Output Areas and Small Areas,OASA,219,44,175
292299,W00009724,W00009724,Output Areas and Small Areas,OASA,262,72,190
292300,W00009725,W00009725,Output Areas and Small Areas,OASA,254,30,224
292301,W00009726,W00009726,Output Areas and Small Areas,OASA,266,65,201
292302,W00009727,W00009727,Output Areas and Small Areas,OASA,245,25,220
292303,W00009728,W00009728,Output Areas and Small Areas,OASA,255,23,232
292304,W00009729,W00009729,Output Areas and Small Areas,OASA,238,27,211
292305,W00009730,W00009730,Output Areas and Small Areas,OASA,230,20,210
292306,W00009731,W00009731,Output Areas and Small Areas,OASA,232,16,216
292307,W00009732,W00009732,Output Areas and Small Areas,OASA,179,5,174
292308,W00009733,W00009733,Output Areas and Small Areas,OASA,245,24,221
292309,W00009734,W00009734,Output Areas and Small Areas,OASA,224,24,200
292310,W00009735,W00009735,Output Areas and Small Areas,OASA,472,37,435
292311,W00009736,W00009736,Output Areas and Small Areas,OASA,275,25,250
292312,W00009737,W00009737,Output Areas and Small Areas,OASA,250,21,229
292313,W00009738,W00009738,Output Areas and Small Areas,OASA,233,21,212
292314,W00009739,W00009739,Output Areas and Small Areas,OASA,273,33,240
292315,W00009740,W00009740,Output Areas and Small Areas,OASA,354,29,325
292316,W00009741,W00009741,Output Areas and Small Areas,OASA,286,53,233
292317,W00009742,W00009742,Output Areas and Small Areas,OASA,257,9,248
292318,W00009743,W00009743,Output Areas and Small Areas,OASA,251,21,230
292319,W00009744,W00009744,Output Areas and Small Areas,OASA,220,7,213
292320,W00009745,W00009745,Output Areas and Small Areas,OASA,223,19,204
292321,W00009746,W00009746,Output Areas and Small Areas,OASA,280,41,239
292322,W00009747,W00009747,Output Areas and Small Areas,OASA,207,15,192
292323,W00009748,W00009748,Output Areas and Small Areas,OASA,192,26,166
292324,W00009749,W00009749,Output Areas and Small Areas,OASA,283,43,240
292325,W00009750,W00009750,Output Areas and Small Areas,OASA,230,16,214
292326,W00009751,W00009751,Output Areas and Small Areas,OASA,344,36,308
292327,W00009752,W00009752,Output Areas and Small Areas,OASA,174,13,161
292328,W00009753,W00009753,Output Areas and Small Areas,OASA,201,25,176
292329,W00009754,W00009754,Output Areas and Small Areas,OASA,182,10,172
292330,W00009755,W00009755,Output Areas and Small Areas,OASA,224,29,195
292331,W00009756,W00009756,Output Areas and Small Areas,OASA,193,11,182
292332,W00009757,W00009757,Output Areas and Small Areas,OASA,225,26,199
292333,W00009758,W00009758,Output Areas and Small Areas,OASA,244,39,205
292334,W00009759,W00009759,Output Areas and Small Areas,OASA,213,32,181
292335,W00009760,W00009760,Output Areas and Small Areas,OASA,262,17,245
292336,W00009761,W00009761,Output Areas and Small Areas,OASA,229,25,204
292337,W00009762,W00009762,Output Areas and Small Areas,OASA,264,68,196
292338,W00009763,W00009763,Output Areas and Small Areas,OASA,265,18,247
292339,W00009764,W00009764,Output Areas and Small Areas,OASA,227,16,211
292340,W00009765,W00009765,Output Areas and Small Areas,OASA,224,30,194
292341,W00009766,W00009766,Output Areas and Small Areas,OASA,245,25,220
292342,W00009767,W00009767,Output Areas and Small Areas,OASA,258,65,193
292343,W00009768,W00009768,Output Areas and Small Areas,OASA,223,22,201
292344,W00009769,W00009769,Output Areas and Small Areas,OASA,202,20,182
292345,W00009770,W00009770,Output Areas and Small Areas,OASA,198,22,176
292346,W00009771,W00009771,Output Areas and Small Areas,OASA,209,13,196
292347,W00009772,W00009772,Output Areas and Small Areas,OASA,315,171,144
292348,W00009773,W00009773,Output Areas and Small Areas,OASA,131,59,72
292349,W00009774,W00009774,Output Areas and Small Areas,OASA,276,10,266
292350,W00009775,W00009775,Output Areas and Small Areas,OASA,229,12,217
292351,W00009776,W00009776,Output Areas and Small Areas,OASA,371,21,350
292352,W00009777,W00009777,Output Areas and Small Areas,OASA,294,35,259
292353,W00009778,W00009778,Output Areas and Small Areas,OASA,163,25,138
292354,W00009779,W00009779,Output Areas and Small Areas,OASA,244,22,222
292355,W00009780,W00009780,Output Areas and Small Areas,OASA,137,23,114
292356,W00009781,W00009781,Output Areas and Small Areas,OASA,285,20,265
292357,W00009782,W00009782,Output Areas and Small Areas,OASA,350,44,306
292358,W00009783,W00009783,Output Areas and Small Areas,OASA,195,17,178
292359,W00009784,W00009784,Output Areas and Small Areas,OASA,137,39,98
292360,W00009785,W00009785,Output Areas and Small Areas,OASA,301,84,217
292361,W00009786,W00009786,Output Areas and Small Areas,OASA,299,107,192
292362,W00009787,W00009787,Output Areas and Small Areas,OASA,326,27,299
292363,W00009788,W00009788,Output Areas and Small Areas,OASA,303,12,291
292364,W00009789,W00009789,Output Areas and Small Areas,OASA,143,4,139
292365,W00009790,W00009790,Output Areas and Small Areas,OASA,206,9,197
292366,W00009791,W00009791,Output Areas and Small Areas,OASA,331,18,313
292367,W00009792,W00009792,Output Areas and Small Areas,OASA,247,21,226
292368,W00009793,W00009793,Output Areas and Small Areas,OASA,96,9,87
292369,W00009794,W00009794,Output Areas and Small Areas,OASA,250,24,226
292370,W00009795,W00009795,Output Areas and Small Areas,OASA,200,9,191
292371,W00009796,W00009796,Output Areas and Small Areas,OASA,371,23,348
292372,W00009797,W00009797,Output Areas and Small Areas,OASA,149,12,137
292373,W00009798,W00009798,Output Areas and Small Areas,OASA,204,8,196
292374,W00009799,W00009799,Output Areas and Small Areas,OASA,224,7,217
292375,W00009800,W00009800,Output Areas and Small Areas,OASA,314,16,298
292376,W00009801,W00009801,Output Areas and Small Areas,OASA,263,12,251
292377,W00009802,W00009802,Output Areas and Small Areas,OASA,259,12,247
292378,W00009803,W00009803,Output Areas and Small Areas,OASA,244,7,237
292379,W00009804,W00009804,Output Areas and Small Areas,OASA,275,16,259
292380,W00009805,W00009805,Output Areas and Small Areas,OASA,215,12,203
292381,W00009806,W00009806,Output Areas and Small Areas,OASA,238,14,224
292382,W00009807,W00009807,Output Areas and Small Areas,OASA,235,7,228
292383,W00009808,W00009808,Output Areas and Small Areas,OASA,201,5,196
292384,W00009809,W00009809,Output Areas and Small Areas,OASA,507,33,474
292385,W00009810,W00009810,Output Areas and Small Areas,OASA,204,10,194
292386,W00009811,W00009811,Output Areas and Small Areas,OASA,136,8,128
292387,W00009812,W00009812,Output Areas and Small Areas,OASA,230,13,217
292388,W00009813,W00009813,Output Areas and Small Areas,OASA,222,16,206
292389,W00009814,W00009814,Output Areas and Small Areas,OASA,105,8,97
292390,W00009815,W00009815,Output Areas and Small Areas,OASA,217,15,202
292391,W00009816,W00009816,Output Areas and Small Areas,OASA,217,8,209
292392,W00009817,W00009817,Output Areas and Small Areas,OASA,384,19,365
292393,W00009818,W00009818,Output Areas and Small Areas,OASA,172,10,162
292394,W00009819,W00009819,Output Areas and Small Areas,OASA,200,11,189
292395,W00009820,W00009820,Output Areas and Small Areas,OASA,144,10,134
292396,W00009821,W00009821,Output Areas and Small Areas,OASA,233,26,207
292397,W00009822,W00009822,Output Areas and Small Areas,OASA,228,16,212
292398,W00009823,W00009823,Output Areas and Small Areas,OASA,213,17,196
292399,W00009824,W00009824,Output Areas and Small Areas,OASA,174,9,165
292400,W00009825,W00009825,Output Areas and Small Areas,OASA,219,20,199
292401,W00009826,W00009826,Output Areas and Small Areas,OASA,497,21,476
292402,W00009827,W00009827,Output Areas and Small Areas,OASA,235,15,220
292403,W00009828,W00009828,Output Areas and Small Areas,OASA,185,12,173
292404,W00009829,W00009829,Output Areas and Small Areas,OASA,207,19,188
292405,W00009830,W00009830,Output Areas and Small Areas,OASA,222,17,205
292406,W00009831,W00009831,Output Areas and Small Areas,OASA,123,8,115
292407,W00009832,W00009832,Output Areas and Small Areas,OASA,183,6,177
292408,W00009833,W00009833,Output Areas and Small Areas,OASA,192,5,187
292409,W00009834,W00009834,Output Areas and Small Areas,OASA,231,15,216
292410,W00009835,W00009835,Output Areas and Small Areas,OASA,203,27,176
292411,W00009836,W00009836,Output Areas and Small Areas,OASA,211,11,200
292412,W00009837,W00009837,Output Areas and Small Areas,OASA,193,6,187
292413,W00009838,W00009838,Output Areas and Small Areas,OASA,177,8,169
292414,W00009839,W00009839,Output Areas and Small Areas,OASA,203,21,182
292415,W00009840,W00009840,Output Areas and Small Areas,OASA,179,12,167
292416,W00009841,W00009841,Output Areas and Small Areas,OASA,803,12,791
292417,W00009842,W00009842,Output Areas and Small Areas,OASA,201,18,183
292418,W00009843,W00009843,Output Areas and Small Areas,OASA,229,19,210
292419,W00009844,W00009844,Output Areas and Small Areas,OASA,189,10,179
292420,W00009845,W00009845,Output Areas and Small Areas,OASA,147,16,131
292421,W00009846,W00009846,Output Areas and Small Areas,OASA,200,21,179
292422,W00009847,W00009847,Output Areas and Small Areas,OASA,233,26,207
292423,W00009848,W00009848,Output Areas and Small Areas,OASA,261,18,243
292424,W00009849,W00009849,Output Areas and Small Areas,OASA,252,22,230
292425,W00009850,W00009850,Output Areas and Small Areas,OASA,158,15,143
292426,W00009851,W00009851,Output Areas and Small Areas,OASA,111,4,107
292427,W00009852,W00009852,Output Areas and Small Areas,OASA,145,11,134
292428,W00009853,W00009853,Output Areas and Small Areas,OASA,123,16,107
292429,W00009854,W00009854,Output Areas and Small Areas,OASA,238,22,216
292430,W00009855,W00009855,Output Areas and Small Areas,OASA,200,9,191
292431,W00009856,W00009856,Output Areas and Small Areas,OASA,182,5,177
292432,W00009857,W00009857,Output Areas and Small Areas,OASA,225,5,220
292433,W00009858,W00009858,Output Areas and Small Areas,OASA,198,11,187
292434,W00009859,W00009859,Output Areas and Small Areas,OASA,276,20,256
292435,W00009860,W00009860,Output Areas and Small Areas,OASA,220,10,210
292436,W00009861,W00009861,Output Areas and Small Areas,OASA,217,16,201
292437,W00009862,W00009862,Output Areas and Small Areas,OASA,244,8,236
292438,W00009863,W00009863,Output Areas and Small Areas,OASA,276,12,264
292439,W00009864,W00009864,Output Areas and Small Areas,OASA,331,12,319
292440,W00009865,W00009865,Output Areas and Small Areas,OASA,224,16,208
292441,W00009866,W00009866,Output Areas and Small Areas,OASA,216,16,200
292442,W00009867,W00009867,Output Areas and Small Areas,OASA,312,13,299
292443,W00009868,W00009868,Output Areas and Small Areas,OASA,244,13,231
292444,W00009869,W00009869,Output Areas and Small Areas,OASA,249,10,239
292445,W00009870,W00009870,Output Areas and Small Areas,OASA,223,9,214
292446,W00009871,W00009871,Output Areas and Small Areas,OASA,272,9,263
292447,W00009872,W00009872,Output Areas and Small Areas,OASA,233,19,214
292448,W00009873,W00009873,Output Areas and Small Areas,OASA,263,5,258
292449,W00009874,W00009874,Output Areas and Small Areas,OASA,139,5,134
292450,W00009875,W00009875,Output Areas and Small Areas,OASA,220,12,208
292451,W00009876,W00009876,Output Areas and Small Areas,OASA,504,52,452
292452,W00009877,W00009877,Output Areas and Small Areas,OASA,209,22,187
292453,W00009878,W00009878,Output Areas and Small Areas,OASA,240,10,230
292454,W00009879,W00009879,Output Areas and Small Areas,OASA,296,21,275
292455,W00009880,W00009880,Output Areas and Small Areas,OASA,266,16,250
292456,W00009881,W00009881,Output Areas and Small Areas,OASA,265,12,253
292457,W00009882,W00009882,Output Areas and Small Areas,OASA,250,16,234
292458,W00009883,W00009883,Output Areas and Small Areas,OASA,232,21,211
292459,W00009884,W00009884,Output Areas and Small Areas,OASA,188,12,176
292460,W00009885,W00009885,Output Areas and Small Areas,OASA,233,6,227
292461,W00009886,W00009886,Output Areas and Small Areas,OASA,706,50,656
292462,W00009887,W00009887,Output Areas and Small Areas,OASA,160,10,150
292463,W00009888,W00009888,Output Areas and Small Areas,OASA,239,6,233
292464,W00009889,W00009889,Output Areas and Small Areas,OASA,150,2,148
292465,W00009890,W00009890,Output Areas and Small Areas,OASA,212,4,208
292466,W00009891,W00009891,Output Areas and Small Areas,OASA,250,13,237
292467,W00009892,W00009892,Output Areas and Small Areas,OASA,241,9,232
292468,W00009893,W00009893,Output Areas and Small Areas,OASA,204,22,182
292469,W00009894,W00009894,Output Areas and Small Areas,OASA,836,77,759
292470,W00009895,W00009895,Output Areas and Small Areas,OASA,341,25,316
292471,W00009896,W00009896,Output Areas and Small Areas,OASA,258,33,225
292472,W00009897,W00009897,Output Areas and Small Areas,OASA,298,47,251
292473,W00009898,W00009898,Output Areas and Small Areas,OASA,234,37,197
292474,W00009899,W00009899,Output Areas and Small Areas,OASA,243,37,206
292475,W00009900,W00009900,Output Areas and Small Areas,OASA,224,26,198
292476,W00009901,W00009901,Output Areas and Small Areas,OASA,268,19,249
292477,W00009902,W00009902,Output Areas and Small Areas,OASA,267,47,220
292478,W00009903,W00009903,Output Areas and Small Areas,OASA,243,37,206
292479,W00009904,W00009904,Output Areas and Small Areas,OASA,203,16,187
292480,W00009905,W00009905,Output Areas and Small Areas,OASA,234,24,210
292481,W00009906,W00009906,Output Areas and Small Areas,OASA,165,19,146
292482,W00009907,W00009907,Output Areas and Small Areas,OASA,237,34,203
292483,W00009908,W00009908,Output Areas and Small Areas,OASA,279,28,251
292484,W00009909,W00009909,Output Areas and Small Areas,OASA,272,45,227
292485,W00009910,W00009910,Output Areas and Small Areas,OASA,226,30,196
292486,W00009911,W00009911,Output Areas and Small Areas,OASA,282,40,242
292487,W00009912,W00009912,Output Areas and Small Areas,OASA,313,38,275
292488,W00009913,W00009913,Output Areas and Small Areas,OASA,247,33,214
292489,W00009914,W00009914,Output Areas and Small Areas,OASA,253,27,226
292490,W00009915,W00009915,Output Areas and Small Areas,OASA,224,34,190
292491,W00009916,W00009916,Output Areas and Small Areas,OASA,174,16,158
292492,W00009917,W00009917,Output Areas and Small Areas,OASA,205,21,184
292493,W00009918,W00009918,Output Areas and Small Areas,OASA,189,22,167
292494,W00009919,W00009919,Output Areas and Small Areas,OASA,279,18,261
292495,W00009920,W00009920,Output Areas and Small Areas,OASA,247,24,223
292496,W00009921,W00009921,Output Areas and Small Areas,OASA,206,20,186
292497,W00009922,W00009922,Output Areas and Small Areas,OASA,186,12,174
292498,W00009923,W00009923,Output Areas and Small Areas,OASA,203,24,179
292499,W00009924,W00009924,Output Areas and Small Areas,OASA,228,23,205
292500,W00009925,W00009925,Output Areas and Small Areas,OASA,234,22,212
292501,W00009926,W00009926,Output Areas and Small Areas,OASA,219,21,198
292502,W00009927,W00009927,Output Areas and Small Areas,OASA,226,36,190
292503,W00009928,W00009928,Output Areas and Small Areas,OASA,248,13,235
292504,W00009929,W00009929,Output Areas and Small Areas,OASA,186,21,165
292505,W00009930,W00009930,Output Areas and Small Areas,OASA,224,23,201
292506,W00009931,W00009931,Output Areas and Small Areas,OASA,216,23,193
292507,W00009932,W00009932,Output Areas and Small Areas,OASA,241,36,205
292508,W00009933,W00009933,Output Areas and Small Areas,OASA,344,15,329
292509,W00009934,W00009934,Output Areas and Small Areas,OASA,249,24,225
292510,W00009935,W00009935,Output Areas and Small Areas,OASA,188,15,173
292511,W00009936,W00009936,Output Areas and Small Areas,OASA,256,34,222
292512,W00009937,W00009937,Output Areas and Small Areas,OASA,245,19,226
292513,W00009938,W00009938,Output Areas and Small Areas,OASA,230,22,208
292514,W00009939,W00009939,Output Areas and Small Areas,OASA,265,32,233
292515,W00009940,W00009940,Output Areas and Small Areas,OASA,181,13,168
292516,W00009941,W00009941,Output Areas and Small Areas,OASA,309,19,290
292517,W00009942,W00009942,Output Areas and Small Areas,OASA,206,19,187
292518,W00009943,W00009943,Output Areas and Small Areas,OASA,262,18,244
292519,W00009944,W00009944,Output Areas and Small Areas,OASA,211,14,197
292520,W00009945,W00009945,Output Areas and Small Areas,OASA,247,19,228
292521,W00009946,W00009946,Output Areas and Small Areas,OASA,219,14,205
292522,W00009947,W00009947,Output Areas and Small Areas,OASA,1544,74,1470
292523,W00009948,W00009948,Output Areas and Small Areas,OASA,272,25,247
292524,W00009949,W00009949,Output Areas and Small Areas,OASA,383,39,344
292525,W00009950,W00009950,Output Areas and Small Areas,OASA,255,28,227
292526,W00009951,W00009951,Output Areas and Small Areas,OASA,318,47,271
292527,W00009952,W00009952,Output Areas and Small Areas,OASA,257,28,229
292528,W00009953,W00009953,Output Areas and Small Areas,OASA,356,22,334
292529,W00009954,W00009954,Output Areas and Small Areas,OASA,249,18,231
292530,W00009955,W00009955,Output Areas and Small Areas,OASA,241,25,216
292531,W00009956,W00009956,Output Areas and Small Areas,OASA,194,18,176
292532,W00009957,W00009957,Output Areas and Small Areas,OASA,232,15,217
292533,W00009958,W00009958,Output Areas and Small Areas,OASA,267,19,248
292534,W00009959,W00009959,Output Areas and Small Areas,OASA,282,26,256
292535,W00009960,W00009960,Output Areas and Small Areas,OASA,221,19,202
292536,W00009961,W00009961,Output Areas and Small Areas,OASA,214,20,194
292537,W00009962,W00009962,Output Areas and Small Areas,OASA,193,19,174
292538,W00009963,W00009963,Output Areas and Small Areas,OASA,305,26,279
292539,W00009964,W00009964,Output Areas and Small Areas,OASA,262,16,246
292540,W00009965,W00009965,Output Areas and Small Areas,OASA,218,13,205
292541,W00009966,W00009966,Output Areas and Small Areas,OASA,324,24,300
292542,W00009967,W00009967,Output Areas and Small Areas,OASA,264,21,243
292543,W00009968,W00009968,Output Areas and Small Areas,OASA,227,17,210
292544,W00009969,W00009969,Output Areas and Small Areas,OASA,111,9,102
292545,W00009970,W00009970,Output Areas and Small Areas,OASA,207,14,193
292546,W00009971,W00009971,Output Areas and Small Areas,OASA,282,27,255
292547,W00009972,W00009972,Output Areas and Small Areas,OASA,216,20,196
292548,W00009973,W00009973,Output Areas and Small Areas,OASA,257,24,233
292549,W00009974,W00009974,Output Areas and Small Areas,OASA,160,20,140
292550,W00009975,W00009975,Output Areas and Small Areas,OASA,251,25,226
292551,W00009976,W00009976,Output Areas and Small Areas,OASA,373,30,343
292552,W00009977,W00009977,Output Areas and Small Areas,OASA,172,105,67
292553,W00009978,W00009978,Output Areas and Small Areas,OASA,239,145,94
292554,W00009979,W00009979,Output Areas and Small Areas,OASA,222,142,80
292555,W00009980,W00009980,Output Areas and Small Areas,OASA,191,113,78
292556,W00009981,W00009981,Output Areas and Small Areas,OASA,248,109,139
292557,W00009982,W00009982,Output Areas and Small Areas,OASA,1737,144,1593
292558,W00009983,W00009983,Output Areas and Small Areas,OASA,463,36,427
292559,W00009984,W00009984,Output Areas and Small Areas,OASA,284,22,262
292560,W00009985,W00009985,Output Areas and Small Areas,OASA,290,22,268
292561,W00009986,W00009986,Output Areas and Small Areas,OASA,209,23,186
292562,W00009987,W00009987,Output Areas and Small Areas,OASA,228,29,199
292563,W00009988,W00009988,Output Areas and Small Areas,OASA,178,33,145
292564,W00009989,W00009989,Output Areas and Small Areas,OASA,285,156,129
292565,W00009991,W00009991,Output Areas and Small Areas,OASA,244,130,114
292566,W00009992,W00009992,Output Areas and Small Areas,OASA,561,202,359
292567,W00009994,W00009994,Output Areas and Small Areas,OASA,261,75,186
292568,W00009995,W00009995,Output Areas and Small Areas,OASA,246,66,180
292569,W00009997,W00009997,Output Areas and Small Areas,OASA,121,52,69
292570,W00009998,W00009998,Output Areas and Small Areas,OASA,159,65,94
292571,W00010000,W00010000,Output Areas and Small Areas,OASA,139,50,89
292572,W00010001,W00010001,Output Areas and Small Areas,OASA,220,70,150
292573,W00010003,W00010003,Output Areas and Small Areas,OASA,200,54,146
292574,W00010004,W00010004,Output Areas and Small Areas,OASA,368,117,251
292575,W00010006,W00010006,Output Areas and Small Areas,OASA,233,58,175
292576,W00010007,W00010007,Output Areas and Small Areas,OASA,147,29,118
292577,W00010009,W00010009,Output Areas and Small Areas,OASA,165,30,135
292578,W00010010,W00010010,Output Areas and Small Areas,OASA,149,22,127
292579,W00010011,W00010011,Output Areas and Small Areas,OASA,177,22,155
292580,W00010012,W00010012,Output Areas and Small Areas,OASA,202,24,178
292581,W00010013,W00010013,Output Areas and Small Areas,OASA,195,24,171
292582,W00010014,W00010014,Output Areas and Small Areas,OASA,183,13,170
292583,W00010015,W00010015,Output Areas and Small Areas,OASA,193,23,170
292584,W00010016,W00010016,Output Areas and Small Areas,OASA,190,13,177
292585,W00010017,W00010017,Output Areas and Small Areas,OASA,193,8,185
292586,W00010018,W00010018,Output Areas and Small Areas,OASA,272,71,201
292587,W00010019,W00010019,Output Areas and Small Areas,OASA,190,18,172
292588,W00010020,W00010020,Output Areas and Small Areas,OASA,123,10,113
292589,W00010021,W00010021,Output Areas and Small Areas,OASA,272,49,223
292590,W00010022,W00010022,Output Areas and Small Areas,OASA,380,13,367
292591,W00010023,W00010023,Output Areas and Small Areas,OASA,375,56,319
292592,W00010024,W00010024,Output Areas and Small Areas,OASA,184,19,165
292593,W00010025,W00010025,Output Areas and Small Areas,OASA,132,22,110
292594,W00010026,W00010026,Output Areas and Small Areas,OASA,210,21,189
292595,W00010027,W00010027,Output Areas and Small Areas,OASA,216,29,187
292596,W00010028,W00010028,Output Areas and Small Areas,OASA,192,7,185
292597,W00010029,W00010029,Output Areas and Small Areas,OASA,237,22,215
292598,W00010030,W00010030,Output Areas and Small Areas,OASA,196,18,178
292599,W00010031,W00010031,Output Areas and Small Areas,OASA,193,15,178
292600,W00010032,W00010032,Output Areas and Small Areas,OASA,204,15,189
292601,W00010033,W00010033,Output Areas and Small Areas,OASA,216,22,194
292602,W00010034,W00010034,Output Areas and Small Areas,OASA,238,26,212
292603,W00010035,W00010035,Output Areas and Small Areas,OASA,188,10,178
292604,W00010036,W00010036,Output Areas and Small Areas,OASA,290,24,266
292605,W00010037,W00010037,Output Areas and Small Areas,OASA,249,24,225
292606,W00010038,W00010038,Output Areas and Small Areas,OASA,222,19,203
292607,W00010039,W00010039,Output Areas and Small Areas,OASA,242,31,211
292608,W00010040,W00010040,Output Areas and Small Areas,OASA,209,13,196
292609,W00010041,W00010041,Output Areas and Small Areas,OASA,306,17,289
292610,W00010042,W00010042,Output Areas and Small Areas,OASA,354,24,330
292611,W00010043,W00010043,Output Areas and Small Areas,OASA,403,51,352
292612,W00010045,W00010045,Output Areas and Small Areas,OASA,227,45,182
292613,W00010046,W00010046,Output Areas and Small Areas,OASA,228,71,157
292614,W00010048,W00010048,Output Areas and Small Areas,OASA,362,67,295
292615,W00010049,W00010049,Output Areas and Small Areas,OASA,2129,322,1807
292616,W00010051,W00010051,Output Areas and Small Areas,OASA,112,36,76
292617,W00010052,W00010052,Output Areas and Small Areas,OASA,371,48,323
292618,W00010054,W00010054,Output Areas and Small Areas,OASA,688,235,453
292619,W00010055,W00010055,Output Areas and Small Areas,OASA,1037,148,889
292620,W00010057,W00010057,Output Areas and Small Areas,OASA,285,45,240
292621,W00010058,W00010058,Output Areas and Small Areas,OASA,493,60,433
292622,W00010060,W00010060,Output Areas and Small Areas,OASA,248,90,158
292623,W00010061,W00010061,Output Areas and Small Areas,OASA,114,47,67
292624,W00010063,W00010063,Output Areas and Small Areas,OASA,123,45,78
292625,W00010064,W00010064,Output Areas and Small Areas,OASA,126,50,76
292626,W00010066,W00010066,Output Areas and Small Areas,OASA,292,121,171
292627,W00010067,W00010067,Output Areas and Small Areas,OASA,570,64,506
292628,W00010069,W00010069,Output Areas and Small Areas,OASA,175,35,140
292629,W00010070,W00010070,Output Areas and Small Areas,OASA,202,21,181
292630,W00010072,W00010072,Output Areas and Small Areas,OASA,178,5,173
292631,W00010073,W00010073,Output Areas and Small Areas,OASA,981,92,889
292632,W00010075,W00010075,Output Areas and Small Areas,OASA,163,9,154
292633,W00010076,W00010076,Output Areas and Small Areas,OASA,173,18,155
292634,W00010078,W00010078,Output Areas and Small Areas,OASA,262,33,229
292635,W00010079,W00010079,Output Areas and Small Areas,OASA,161,51,110
292636,W00010081,W00010081,Output Areas and Small Areas,OASA,151,54,97
292637,W00010082,W00010082,Output Areas and Small Areas,OASA,145,31,114
292638,W00010084,W00010084,Output Areas and Small Areas,OASA,262,28,234
292639,W00010085,W00010085,Output Areas and Small Areas,OASA,178,65,113
292640,W00010087,W00010087,Output Areas and Small Areas,OASA,817,72,745
292641,W00010088,W00010088,Output Areas and Small Areas,OASA,815,62,753
292642,W00010090,W00010090,Output Areas and Small Areas,OASA,167,14,153
292643,W00010091,W00010091,Output Areas and Small Areas,OASA,171,10,161
292644,W00010093,W00010093,Output Areas and Small Areas,OASA,195,18,177
292645,W00010094,W00010094,Output Areas and Small Areas,OASA,190,13,177
292646,W00010096,W00010096,Output Areas and Small Areas,OASA,191,19,172
292647,W00010097,W00010097,Output Areas and Small Areas,OASA,157,8,149
292648,W00010099,W00010099,Output Areas and Small Areas,OASA,206,49,157
292649,W00010100,W00010100,Output Areas and Small Areas,OASA,200,55,145
292650,W00010102,W00010102,Output Areas and Small Areas,OASA,188,45,143
292651,W00010103,W00010103,Output Areas and Small Areas,OASA,323,111,212
292652,W00010105,W00010105,Output Areas and Small Areas,OASA,317,57,260
292653,W00010106,W00010106,Output Areas and Small Areas,OASA,306,71,235
292654,W00010108,W00010108,Output Areas and Small Areas,OASA,239,78,161
292655,W00010109,W00010109,Output Areas and Small Areas,OASA,298,22,276
292656,W00010110,W00010110,Output Areas and Small Areas,OASA,208,20,188
292657,W00010111,W00010111,Output Areas and Small Areas,OASA,300,18,282
292658,W00010112,W00010112,Output Areas and Small Areas,OASA,193,33,160
292659,W00010113,W00010113,Output Areas and Small Areas,OASA,232,28,204
292660,W00010114,W00010114,Output Areas and Small Areas,OASA,220,41,179
292661,W00010115,W00010115,Output Areas and Small Areas,OASA,854,126,728
292662,W00010116,W00010116,Output Areas and Small Areas,OASA,213,4,209
292663,W00010117,W00010117,Output Areas and Small Areas,OASA,209,18,191
292664,W00010118,W00010118,Output Areas and Small Areas,OASA,532,36,496
292665,W00010119,W00010119,Output Areas and Small Areas,OASA,745,88,657
292666,W00010120,W00010120,Output Areas and Small Areas,OASA,282,25,257
292667,W00010121,W00010121,Output Areas and Small Areas,OASA,215,14,201
292668,W00010122,W00010122,Output Areas and Small Areas,OASA,197,8,189
292669,W00010123,W00010123,Output Areas and Small Areas,OASA,868,126,742
292670,W00010124,W00010124,Output Areas and Small Areas,OASA,232,42,190
292671,W00010125,W00010125,Output Areas and Small Areas,OASA,366,47,319
292672,W00010126,W00010126,Output Areas and Small Areas,OASA,1077,101,976
292673,W00010127,W00010127,Output Areas and Small Areas,OASA,177,14,163
292674,W00010128,W00010128,Output Areas and Small Areas,OASA,774,46,728
292675,W00010129,W00010129,Output Areas and Small Areas,OASA,140,9,131
292676,W00010130,W00010130,Output Areas and Small Areas,OASA,181,12,169
292677,W00010131,W00010131,Output Areas and Small Areas,OASA,357,22,335
292678,W00010132,W00010132,Output Areas and Small Areas,OASA,183,17,166
292679,W00010133,W00010133,Output Areas and Small Areas,OASA,314,38,276
292680,W00010134,W00010134,Output Areas and Small Areas,OASA,226,19,207
292681,W00010135,W00010135,Output Areas and Small Areas,OASA,273,18,255
292682,W00010136,W00010136,Output Areas and Small Areas,OASA,226,16,210
292683,W00010137,W00010137,Output Areas and Small Areas,OASA,436,17,419
292684,W00010138,W00010138,Output Areas and Small Areas,OASA,182,21,161
292685,W00010139,W00010139,Output Areas and Small Areas,OASA,326,35,291
292686,W00010140,W00010140,Output Areas and Small Areas,OASA,345,31,314
292687,W00010141,W00010141,Output Areas and Small Areas,OASA,191,15,176
292688,W00010142,W00010142,Output Areas and Small Areas,OASA,272,13,259
292689,W00010143,W00010143,Output Areas and Small Areas,OASA,165,18,147
292690,W00010144,W00010144,Output Areas and Small Areas,OASA,254,26,228
292691,W00010145,W00010145,Output Areas and Small Areas,OASA,158,18,140
292692,W00010146,W00010146,Output Areas and Small Areas,OASA,211,13,198
292693,W00010147,W00010147,Output Areas and Small Areas,OASA,227,34,193
292694,W00010148,W00010148,Output Areas and Small Areas,OASA,130,9,121
292695,W00010149,W00010149,Output Areas and Small Areas,OASA,219,19,200
292696,W00010150,W00010150,Output Areas and Small Areas,OASA,289,34,255
292697,W00010151,W00010151,Output Areas and Small Areas,OASA,228,13,215
292698,W00010152,W00010152,Output Areas and Small Areas,OASA,236,28,208
292699,W00010153,W00010153,Output Areas and Small Areas,OASA,144,19,125
292700,W00010154,W00010154,Output Areas and Small Areas,OASA,227,17,210
292701,W00010155,W00010155,Output Areas and Small Areas,OASA,186,12,174
292702,W00010156,W00010156,Output Areas and Small Areas,OASA,168,18,150
292703,W00010157,W00010157,Output Areas and Small Areas,OASA,225,10,215
292704,W00010158,W00010158,Output Areas and Small Areas,OASA,339,40,299
292705,W00010159,W00010159,Output Areas and Small Areas,OASA,194,17,177
292706,W00010160,W00010160,Output Areas and Small Areas,OASA,156,27,129
292707,W00010161,W00010161,Output Areas and Small Areas,OASA,198,24,174
292708,W00010162,W00010162,Output Areas and Small Areas,OASA,230,18,212
292709,W00010163,W00010163,Output Areas and Small Areas,OASA,240,28,212
292710,W00010164,W00010164,Output Areas and Small Areas,OASA,217,28,189
292711,W00010165,W00010165,Output Areas and Small Areas,OASA,174,11,163
292712,W00010166,W00010166,Output Areas and Small Areas,OASA,224,18,206
292713,W00010167,W00010167,Output Areas and Small Areas,OASA,151,11,140
292714,W00010168,W00010168,Output Areas and Small Areas,OASA,162,15,147
292715,W00010169,W00010169,Output Areas and Small Areas,OASA,346,17,329
292716,W00010170,W00010170,Output Areas and Small Areas,OASA,167,4,163
292717,W00010171,W00010171,Output Areas and Small Areas,OASA,199,18,181
292718,W00010172,W00010172,Output Areas and Small Areas,OASA,258,15,243
292719,W00010173,W00010173,Output Areas and Small Areas,OASA,185,27,158
292720,W00010174,W00010174,Output Areas and Small Areas,OASA,201,19,182
292721,W00010175,W00010175,Output Areas and Small Areas,OASA,190,11,179
292722,W00010176,W00010176,Output Areas and Small Areas,OASA,309,21,288
292723,W00010177,W00010177,Output Areas and Small Areas,OASA,247,13,234
292724,W00010178,W00010178,Output Areas and Small Areas,OASA,1336,74,1262
292725,W00010179,W00010179,Output Areas and Small Areas,OASA,119,4,115
292726,W00010180,W00010180,Output Areas and Small Areas,OASA,256,14,242
292727,W00010181,W00010181,Output Areas and Small Areas,OASA,212,15,197
292728,W00010182,W00010182,Output Areas and Small Areas,OASA,251,40,211
292729,W00010183,W00010183,Output Areas and Small Areas,OASA,214,13,201
292730,W00010184,W00010184,Output Areas and Small Areas,OASA,215,21,194
292731,W00010185,W00010185,Output Areas and Small Areas,OASA,222,29,193
292732,W00010186,W00010186,Output Areas and Small Areas,OASA,167,21,146
292733,W00010187,W00010187,Output Areas and Small Areas,OASA,420,45,375
292734,W00010188,W00010188,Output Areas and Small Areas,OASA,121,12,109
292735,W00010189,W00010189,Output Areas and Small Areas,OASA,168,12,156
292736,W00010190,W00010190,Output Areas and Small Areas,OASA,235,17,218
292737,W00010191,W00010191,Output Areas and Small Areas,OASA,175,11,164
292738,W00010192,W00010192,Output Areas and Small Areas,OASA,233,19,214
292739,W00010193,W00010193,Output Areas and Small Areas,OASA,285,18,267
292740,W00010194,W00010194,Output Areas and Small Areas,OASA,220,23,197
292741,W00010195,W00010195,Output Areas and Small Areas,OASA,159,21,138
292742,W00010196,W00010196,Output Areas and Small Areas,OASA,173,23,150
292743,W00010197,W00010197,Output Areas and Small Areas,OASA,204,29,175
292744,W00010198,W00010198,Output Areas and Small Areas,OASA,228,17,211
292745,W00010199,W00010199,Output Areas and Small Areas,OASA,219,12,207
292746,W00010200,W00010200,Output Areas and Small Areas,OASA,234,27,207
292747,W00010201,W00010201,Output Areas and Small Areas,OASA,206,24,182
292748,W00010202,W00010202,Output Areas and Small Areas,OASA,204,31,173
292749,W00010203,W00010203,Output Areas and Small Areas,OASA,153,10,143
292750,W00010204,W00010204,Output Areas and Small Areas,OASA,208,34,174
292751,W00010205,W00010205,Output Areas and Small Areas,OASA,219,17,202
292752,W00010206,W00010206,Output Areas and Small Areas,OASA,185,7,178
292753,W00010207,W00010207,Output Areas and Small Areas,OASA,212,11,201
292754,W00010208,W00010208,Output Areas and Small Areas,OASA,224,11,213
292755,W00010209,W00010209,Output Areas and Small Areas,OASA,257,32,225
292756,W00010210,W00010210,Output Areas and Small Areas,OASA,128,9,119
292757,W00010211,W00010211,Output Areas and Small Areas,OASA,139,10,129
292758,W00010212,W00010212,Output Areas and Small Areas,OASA,105,4,101
292759,W00010213,W00010213,Output Areas and Small Areas,OASA,144,9,135
292760,W00010214,W00010214,Output Areas and Small Areas,OASA,261,18,243
292761,W00010215,W00010215,Output Areas and Small Areas,OASA,219,30,189
292762,W00010216,W00010216,Output Areas and Small Areas,OASA,187,23,164
292763,W00010217,W00010217,Output Areas and Small Areas,OASA,162,12,150
292764,W00010218,W00010218,Output Areas and Small Areas,OASA,160,14,146
292765,W00010219,W00010219,Output Areas and Small Areas,OASA,277,25,252
292766,W00010220,W00010220,Output Areas and Small Areas,OASA,220,17,203
292767,W00010221,W00010221,Output Areas and Small Areas,OASA,236,28,208
292768,W00010222,W00010222,Output Areas and Small Areas,OASA,265,30,235
292769,W00010223,W00010223,Output Areas and Small Areas,OASA,553,26,527
292770,W00010224,W00010224,Output Areas and Small Areas,OASA,166,11,155
292771,W00010225,W00010225,Output Areas and Small Areas,OASA,199,12,187
292772,W00010226,W00010226,Output Areas and Small Areas,OASA,172,12,160
292773,W00010227,W00010227,Output Areas and Small Areas,OASA,199,19,180
292774,W00010228,W00010228,Output Areas and Small Areas,OASA,282,32,250
292775,W00010229,W00010229,Output Areas and Small Areas,OASA,130,9,121
292776,W00010230,W00010230,Output Areas and Small Areas,OASA,163,19,144
292777,W00010231,W00010231,Output Areas and Small Areas,OASA,211,37,174
292778,W00010232,W00010232,Output Areas and Small Areas,OASA,588,41,547
292779,W00010233,W00010233,Output Areas and Small Areas,OASA,232,35,197
292780,W00010234,W00010234,Output Areas and Small Areas,OASA,237,25,212
292781,W00010235,W00010235,Output Areas and Small Areas,OASA,227,18,209
292782,W00010236,W00010236,Output Areas and Small Areas,OASA,202,14,188
292783,W00010237,W00010237,Output Areas and Small Areas,OASA,207,22,185
292784,W00010238,W00010238,Output Areas and Small Areas,OASA,209,28,181
292785,W00010239,W00010239,Output Areas and Small Areas,OASA,130,8,122
292786,W00010240,W00010240,Output Areas and Small Areas,OASA,208,19,189
292787,W00010241,W00010241,Output Areas and Small Areas,OASA,171,23,148
292788,W00010242,W00010242,Output Areas and Small Areas,OASA,252,10,242
292789,W00010243,W00010243,Output Areas and Small Areas,OASA,262,49,213
292790,W00010244,W00010244,Output Areas and Small Areas,OASA,246,11,235
292791,W00010245,W00010245,Output Areas and Small Areas,OASA,195,18,177
292792,W00010246,W00010246,Output Areas and Small Areas,OASA,189,13,176
292793,W00010247,W00010247,Output Areas and Small Areas,OASA,263,33,230
292794,W00010248,W00010248,Output Areas and Small Areas,OASA,261,26,235
292795,W00010249,W00010249,Output Areas and Small Areas,OASA,234,30,204
292796,W00010250,W00010250,Output Areas and Small Areas,OASA,268,36,232
292797,W00010251,W00010251,Output Areas and Small Areas,OASA,268,16,252
292798,W00010252,W00010252,Output Areas and Small Areas,OASA,195,21,174
292799,W00010253,W00010253,Output Areas and Small Areas,OASA,169,9,160
292800,W00010254,W00010254,Output Areas and Small Areas,OASA,102,6,96
292801,W00010255,W00010255,Output Areas and Small Areas,OASA,145,6,139
292802,W00010256,W00010256,Output Areas and Small Areas,OASA,223,7,216
292803,W00010257,W00010257,Output Areas and Small Areas,OASA,214,61,153
292804,W00010258,W00010258,Output Areas and Small Areas,OASA,107,8,99
292805,W00010259,W00010259,Output Areas and Small Areas,OASA,235,23,212
292806,W00010260,W00010260,Output Areas and Small Areas,OASA,276,41,235
292807,W00010261,W00010261,Output Areas and Small Areas,OASA,232,13,219
292808,W00010262,W00010262,Output Areas and Small Areas,OASA,168,10,158
292809,W00010263,W00010263,Output Areas and Small Areas,OASA,204,22,182
292810,W00010264,W00010264,Output Areas and Small Areas,OASA,212,28,184
292811,W00010265,W00010265,Output Areas and Small Areas,OASA,134,12,122